SWSN_ID,Site,Type,Count,Begin,End,Length,Chronology,cyberSW,painted
665,Aragon,Alma Plain,6,300,1000,700,0,0,0
665,Aragon,"Cibola White Ware, Undifferentiated",4,550,1325,775,0,1,1
665,Aragon,"Mogollon Corrugated Brown Ware, Undifferentiated",1,800,1400,600,0,0,0
665,Aragon,Mogollon Indented Corrugated Brown Ware,2,1000,1400,400,0,0,0
665,Aragon,"Mogollon Patterned Corrugated Brown Ware, Smudged",1,1000,1400,400,0,0,0
665,Aragon,Mogollon Plain Brown Ware,1,300,1400,1100,0,0,0
665,Aragon,Mogollon Plain Corrugated Brown Ware,1,900,1400,500,0,0,0
665,Aragon,"Mogollon Plain Corrugated Brown Ware, Smudged",1,900,1400,500,0,0,0
665,Aragon,Puerco Black-on-white,1,1030,1200,170,1,1,1
665,Aragon,Red Mesa Black-on-white,3,880,1040,160,1,1,1
665,Aragon,"Red Ware type, Undifferentiated",2,700,1700,1000,0,0,0
665,Aragon,Reserve Black-on-white,1,1050,1200,150,1,1,1
665,Aragon,San Francisco Red,1,550,950,400,0,0,0
665,Aragon,Snowflake Black-on-white,3,1100,1275,175,1,1,1
665,Aragon,St. Johns Polychrome,1,1200,1300,100,1,1,1
665,Aragon,Tularosa Fillet Rim,4,1100,1350,250,0,0,0
665,Aragon,Wingate Black-on-red,2,1050,1225,175,1,1,1
665,Aragon,Wingate Polychrome,1,1100,1225,125,1,1,1
708,Aztec,Alma Plain,1,300,1000,700,0,0,0
708,Aztec,Aztec Black,2,1200,1300,100,0,1,0
708,Aztec,Bancos Black-on-white,2,825,1000,175,1,1,1
708,Aztec,Black Mesa Black-on-white,6,1000,1100,100,1,1,1
708,Aztec,"Black-on-red, Undifferentiated",20,700,1700,1000,0,1,1
708,Aztec,Blue Shale Corrugated,4,925,1150,225,0,0,0
708,Aztec,Brimhall Black-on-white,1,1040,1150,110,1,1,1
708,Aztec,Cameron Polychrome,14,1040,1170,130,1,1,1
708,Aztec,Cedar Creek Polychrome,1,1300,1350,50,1,1,1
708,Aztec,Chaco Black-on-white,31,1075,1150,75,1,1,1
708,Aztec,Chaco-McElmo Black-on-white (carbon paint),480,1090,1175,85,1,1,1
708,Aztec,Chuska Black-on-white,21,1040,1125,85,1,1,1
708,Aztec,"Cibola BMIII/PI White Ware, Type Undifferentiated",2,550,900,350,0,1,1
708,Aztec,"Cibola PII White Ware, Type Undifferentiated",87,880,1100,220,1,1,1
708,Aztec,"Cibola PII/PIII White Ware, Type Undifferentiated",5,1000,1300,300,1,1,1
708,Aztec,"Cibola PIII White Ware, Type Undifferentiated",1237,1100,1300,200,1,1,1
708,Aztec,Citadel Polychrome,14,1040,1200,160,1,1,1
708,Aztec,"Corrugated Gray Ware, Undifferentiated",3810,800,1400,600,0,0,0
708,Aztec,Cortez Black-on-white,11,880,1060,180,1,1,1
708,Aztec,Crumbled House Black-on-white,8,1150,1300,150,1,1,1
708,Aztec,Dogoszhi Black-on-white,16,1040,1210,170,1,1,1
708,Aztec,Dogoszhi Polychrome,45,1040,1320,280,1,1,1
708,Aztec,Dolores Corrugated,3,1100,1200,100,0,1,0
708,Aztec,Escavada Black-on-white,82,1000,1100,100,1,1,1
708,Aztec,Flagstaff Black-on-white,3,1150,1220,70,1,1,1
708,Aztec,Gallup Black-on-white,150,1040,1150,110,1,1,1
708,Aztec,Hunter Corrugated,2,1100,1300,200,0,1,0
708,Aztec,Kayenta Polychrome,1,1250,1320,70,1,1,1
708,Aztec,Mancos Black-on-white,406,980,1180,200,1,1,1
708,Aztec,Mancos Corrugated,1,920,1180,260,0,0,0
708,Aztec,Mancos Gray,2,880,1060,180,0,1,0
708,Aztec,McElmo Black-on-white,1107,1060,1260,200,1,1,1
708,Aztec,McElmo/Mesa Verde Black-on-white,119,1060,1280,220,1,1,1
708,Aztec,Medicine Black-on-red,5,1040,1170,130,1,1,1
708,Aztec,Mesa Verde Black-on-white,2304,1180,1280,100,1,1,1
708,Aztec,"Mesa Verde Corrugated Gray Ware, Undifferentiated",2,920,1280,360,0,0,0
708,Aztec,Mimbres Style III Black-on-white (Classic),1,1010,1130,120,1,1,1
708,Aztec,Moccasin Gray,2,800,980,180,0,1,0
708,Aztec,Mogollon Patterned Corrugated Brown Ware,2,1000,1400,400,0,0,0
708,Aztec,"Mogollon Plain Brown Ware, Smudged",2,300,1400,1100,0,0,0
708,Aztec,"Mudware, Undifferentiated",2,400,1400,1000,0,0,0
708,Aztec,Naschitti Black-on-white,2,900,1000,100,1,1,1
708,Aztec,Nava Black-on-white,33,1100,1275,175,1,1,1
708,Aztec,Newcomb Black-on-white,1,875,1000,125,1,1,1
708,Aztec,Piedra Black-on-white,1,800,920,120,1,1,1
708,Aztec,"PII Gray Rim, Type Undifferentiated",24,900,1100,200,0,1,0
708,Aztec,"PII/PIII Gray Rim, Type Undifferentiated",166,900,1300,400,0,0,0
708,Aztec,"PIII Gray Rim, Type Undifferentiated",15,1100,1300,200,0,1,0
708,Aztec,"Plain Brown Smudged, Undifferentiated",1,400,1450,1050,0,0,0
708,Aztec,"Plain Brown Ware, Undifferentiated",30,400,1450,1050,0,0,0
708,Aztec,"Plain Gray Ware, Undifferentiated",176,500,1300,800,0,0,0
708,Aztec,Polacca Black-on-white,1,1150,1250,100,1,1,1
708,Aztec,"Polychrome, Undifferentiated",3,700,1900,1200,0,1,1
708,Aztec,Puerco Black-on-red,141,1000,1175,175,1,1,1
708,Aztec,Puerco Black-on-white,7,1030,1200,170,1,1,1
708,Aztec,Red Mesa Black-on-white,5,880,1040,160,1,1,1
708,Aztec,"Red Ware type, Undifferentiated",29,700,1700,1000,0,0,0
708,Aztec,Reserve Black-on-white,8,1050,1200,150,1,1,1
708,Aztec,Showlow Red,63,1000,1100,100,0,1,0
708,Aztec,Snowflake Black-on-white,1,1100,1275,175,1,1,1
708,Aztec,Sosi Black-on-white,13,1070,1180,110,1,1,1
708,Aztec,St. Johns Black-on-red,45,1200,1300,100,1,1,1
708,Aztec,St. Johns Polychrome,86,1200,1300,100,1,1,1
708,Aztec,Taylor Black-on-white,8,1000,1100,100,1,1,1
708,Aztec,Toadlena Black-on-white,35,975,1125,150,1,1,1
708,Aztec,Tsegi Black-on-orange,2,1225,1300,75,1,1,1
708,Aztec,Tsegi Orange,1,1250,1300,50,1,1,1
708,Aztec,Tsegi Red-on-orange,1,1200,1300,100,1,1,1
708,Aztec,Tularosa Black-on-white,1,1180,1300,120,1,1,1
708,Aztec,Tularosa Fillet Rim,2,1100,1350,250,0,0,0
708,Aztec,Tusayan Black-on-red,84,1045,1240,195,1,1,1
708,Aztec,Tusayan Polychrome,2,1110,1320,210,1,1,1
708,Aztec,"Type, Undifferentiated",9,200,1900,1700,0,0,0
708,Aztec,"White Mountain type, Type Undifferentiated; Early",164,1000,1300,300,0,0,1
708,Aztec,"White ware, Undifferentiated",2115,550,1900,1350,0,0,1
708,Aztec,Wingate Black-on-red,80,1050,1225,175,1,1,1
708,Aztec,Wingate Polychrome,145,1100,1225,125,1,1,1
708,Aztec,Woodruff Smudged,11,500,1100,600,0,0,0
720,Pueblo Pintado,Black Mesa/Sosi Black-on-white,4,1000,1180,180,1,1,1
720,Pueblo Pintado,Brimhall Black-on-white,1,1040,1150,110,1,1,1
720,Pueblo Pintado,Chaco Black-on-white,11,1075,1150,75,1,1,1
720,Pueblo Pintado,Chaco-McElmo Black-on-white (carbon paint),29,1090,1175,85,1,1,1
720,Pueblo Pintado,Chuska Black-on-white,2,1040,1125,85,1,1,1
720,Pueblo Pintado,"Chuska Carbon Painted White Ware, Undifferentiated",8,800,1300,500,0,1,1
720,Pueblo Pintado,Chuska Indented Corrugated Gray,41,1040,1300,260,0,0,0
720,Pueblo Pintado,"Chuska White Ware type, Undifferentiated",10,800,1300,500,0,1,1
720,Pueblo Pintado,"Cibola Black-on-white, Undifferentiated",247,550,1325,775,0,1,1
720,Pueblo Pintado,Cibola Indented Corrugated Gray,120,1040,1400,360,0,0,0
720,Pueblo Pintado,Cibola Neckbanded Gray,30,850,1025,175,0,1,0
720,Pueblo Pintado,Cibola Plain Gray,95,550,1040,490,0,0,0
720,Pueblo Pintado,"Cibola White Ware, Undifferentiated",275,550,1325,775,0,1,1
720,Pueblo Pintado,"Corrugated Gray Ware, Undifferentiated",371,800,1400,600,0,0,0
720,Pueblo Pintado,Deadmans (La Plata) Black-on-red,1,880,1050,170,1,1,1
720,Pueblo Pintado,Escavada Black-on-white,7,1000,1100,100,1,1,1
720,Pueblo Pintado,Escavada-Puerco Black-on-white,11,1000,1100,100,1,1,1
720,Pueblo Pintado,Gallup Black-on-white,144,1040,1150,110,1,1,1
720,Pueblo Pintado,"Indented Corrugated Gray Ware, Undifferentiated",458,950,1400,450,0,0,0
720,Pueblo Pintado,Kana-a Black-on-white,3,825,1000,175,1,1,1
720,Pueblo Pintado,Kiatuthlanna Black-on-white,1,850,925,75,1,1,1
720,Pueblo Pintado,Kiatuthlanna-Red Mesa Black-on-white,1,850,1040,190,1,1,1
720,Pueblo Pintado,Mancos Black-on-white,17,980,1180,200,1,1,1
720,Pueblo Pintado,McElmo Black-on-white,43,1060,1260,200,1,1,1
720,Pueblo Pintado,McElmo/Mesa Verde Black-on-white,49,1060,1280,220,1,1,1
720,Pueblo Pintado,Mesa Verde Black-on-white,38,1180,1280,100,1,1,1
720,Pueblo Pintado,"Mesa Verde White Ware, Undifferentiated",52,575,1280,705,0,1,1
720,Pueblo Pintado,"Narrow Neckbanded Gray Ware, Type Undifferentiated",159,900,1025,125,0,1,0
720,Pueblo Pintado,"PII Gray Rim, Type Undifferentiated",21,900,1100,200,0,1,0
720,Pueblo Pintado,"PII/PIII Gray Rim, Type Undifferentiated",10,900,1300,400,0,0,0
720,Pueblo Pintado,"PII/PIII White Ware, Type Undifferentiated",131,900,1300,400,0,1,1
720,Pueblo Pintado,"PIII Gray Rim, Type Undifferentiated",7,1100,1300,200,0,1,0
720,Pueblo Pintado,"Plain Gray Ware, Undifferentiated",422,500,1300,800,0,0,0
720,Pueblo Pintado,Puerco Black-on-red,11,1000,1175,175,1,1,1
720,Pueblo Pintado,Puerco Black-on-white,30,1030,1200,170,1,1,1
720,Pueblo Pintado,Red Mesa Black-on-white,131,880,1040,160,1,1,1
720,Pueblo Pintado,Toadlena Black-on-white,3,975,1125,150,1,1,1
720,Pueblo Pintado,"White Mountain type, Type Undifferentiated; Early",1,1000,1300,300,0,0,1
720,Pueblo Pintado,"White ware, Undifferentiated",227,550,1900,1350,0,0,1
720,Pueblo Pintado,"Wide Neckbanded Gray Ware, Type Undifferentiated",42,850,925,75,0,1,0
720,Pueblo Pintado,Woodruff Smudged,8,500,1100,600,0,0,0
727,Morris 39,Bluff Black-on-red,4,800,925,125,1,1,1
727,Morris 39,Captain Tom Corrugated,1,890,1000,110,0,1,0
727,Morris 39,Chaco Black-on-white,1,1075,1150,75,1,1,1
727,Morris 39,Chaco-McElmo Black-on-white (carbon paint),1,1090,1175,85,1,1,1
727,Morris 39,Chapin Gray,1,575,980,405,0,0,0
727,Morris 39,Citadel Polychrome,1,1040,1200,160,1,1,1
727,Morris 39,"Corrugated Gray Ware, Undifferentiated",4,800,1400,600,0,0,0
727,Morris 39,Cortez Black-on-white,116,880,1060,180,1,1,1
727,Morris 39,Deadmans (La Plata) Black-on-red,5,880,1050,170,1,1,1
727,Morris 39,Escavada Black-on-white,5,1000,1100,100,1,1,1
727,Morris 39,Gallup Black-on-white,7,1040,1150,110,1,1,1
727,Morris 39,"Gray Ware, Undifferentiated",3238,400,1400,1000,0,0,0
727,Morris 39,Kiatuthlanna Black-on-white,1,850,925,75,1,1,1
727,Morris 39,Mancos Black-on-white,85,980,1180,200,1,1,1
727,Morris 39,McElmo Black-on-white,20,1060,1260,200,1,1,1
727,Morris 39,Mesa Verde Black-on-white,4,1180,1280,100,1,1,1
727,Morris 39,Naschitti Black-on-white,2,900,1000,100,1,1,1
727,Morris 39,"Neck Indented Corrugated Gray Ware, Type Undifferentiated",1,950,1025,75,0,1,0
727,Morris 39,Newcomb Black-on-white,3,875,1000,125,1,1,1
727,Morris 39,"PI White Ware, Type Undifferentiated",1,700,900,200,1,1,1
727,Morris 39,"PII Gray Rim, Type Undifferentiated",4,900,1100,200,0,1,0
727,Morris 39,"PII White Ware, Type Undifferentiated",5,900,1100,200,1,1,1
727,Morris 39,"PII/PIII Gray Rim, Type Undifferentiated",3,900,1300,400,0,0,0
727,Morris 39,"PIII White Ware, Type Undifferentiated",14,1100,1300,200,1,1,1
727,Morris 39,Puerco Black-on-white,1,1030,1200,170,1,1,1
727,Morris 39,Red Mesa Black-on-white,32,880,1040,160,1,1,1
727,Morris 39,"Red Ware type, Undifferentiated",9,700,1700,1000,0,0,0
727,Morris 39,Showlow Red,3,1000,1100,100,0,1,0
727,Morris 39,Taylor Black-on-white,1,1000,1100,100,1,1,1
727,Morris 39,Toadlena Black-on-white,1,975,1125,150,1,1,1
727,Morris 39,Tunicha Black-on-white,1,850,900,50,1,1,1
727,Morris 39,"White ware, Undifferentiated",979,550,1900,1350,0,0,1
727,Morris 39,Wingate Black-on-red,2,1050,1225,175,1,1,1
728,Holmes Group,Abajo Red-on-orange,1,760,880,120,1,1,1
728,Holmes Group,Bluff Black-on-red,1,800,925,125,1,1,1
728,Holmes Group,Brimhall Black-on-white,3,1040,1150,110,1,1,1
728,Holmes Group,Chaco-McElmo Black-on-white (carbon paint),3,1090,1175,85,1,1,1
728,Holmes Group,"Corrugated Gray Ware, Undifferentiated",40,800,1400,600,0,0,0
728,Holmes Group,Cortez Black-on-white,5,880,1060,180,1,1,1
728,Holmes Group,Escavada Black-on-white,1,1000,1100,100,1,1,1
728,Holmes Group,Gallup Black-on-white,6,1040,1150,110,1,1,1
728,Holmes Group,"Gray Ware, Undifferentiated",1,400,1400,1000,0,0,0
728,Holmes Group,Mancos Black-on-white,41,980,1180,200,1,1,1
728,Holmes Group,Mancos Corrugated,1,920,1180,260,0,0,0
728,Holmes Group,McElmo Black-on-white,26,1060,1260,200,1,1,1
728,Holmes Group,Mesa Verde Black-on-white,11,1180,1280,100,1,1,1
728,Holmes Group,"PII Gray Rim, Type Undifferentiated",9,900,1100,200,0,1,0
728,Holmes Group,"PII White Ware, Type Undifferentiated",5,900,1100,200,1,1,1
728,Holmes Group,"Plain Gray Ware, Undifferentiated",13,500,1300,800,0,0,0
728,Holmes Group,Red Mesa Black-on-white,1,880,1040,160,1,1,1
728,Holmes Group,"Red Ware type, Undifferentiated",1,700,1700,1000,0,0,0
728,Holmes Group,Showlow Red,1,1000,1100,100,0,1,0
728,Holmes Group,"Type, Undifferentiated",1209,200,1900,1700,0,0,0
728,Holmes Group,"White ware, Undifferentiated",530,550,1900,1350,0,0,1
730,Flora Vista,Blue Shale Corrugated,2,925,1150,225,0,0,0
730,Flora Vista,Chaco Corrugated,1,1050,1100,50,0,1,0
730,Flora Vista,Chaco-McElmo Black-on-white (carbon paint),6,1090,1175,85,1,1,1
730,Flora Vista,Chuska Black-on-white,1,1040,1125,85,1,1,1
730,Flora Vista,"Corrugated Gray Ware, Undifferentiated",1,800,1400,600,0,0,0
730,Flora Vista,Cortez Black-on-white,1,880,1060,180,1,1,1
730,Flora Vista,Escavada Black-on-white,2,1000,1100,100,1,1,1
730,Flora Vista,Gallup Black-on-white,2,1040,1150,110,1,1,1
730,Flora Vista,"Indented Corrugated Gray Ware, Undifferentiated",166,950,1400,450,0,0,0
730,Flora Vista,Mancos Black-on-white,7,980,1180,200,1,1,1
730,Flora Vista,McElmo Black-on-white,77,1060,1260,200,1,1,1
730,Flora Vista,McElmo/Mesa Verde Black-on-white,3,1060,1280,220,1,1,1
730,Flora Vista,Mesa Verde Black-on-white,157,1180,1280,100,1,1,1
730,Flora Vista,"PII Gray Rim, Type Undifferentiated",3,900,1100,200,0,1,0
730,Flora Vista,"PII/PIII Gray Rim, Type Undifferentiated",4,900,1300,400,0,0,0
730,Flora Vista,"PIII White Ware, Type Undifferentiated",40,1100,1300,200,1,1,1
730,Flora Vista,"Plain Gray Ware, Undifferentiated",18,500,1300,800,0,0,0
730,Flora Vista,Puerco Black-on-red,2,1000,1175,175,1,1,1
730,Flora Vista,Red Mesa Black-on-white,1,880,1040,160,1,1,1
730,Flora Vista,St. Johns Black-on-red,5,1200,1300,100,1,1,1
730,Flora Vista,St. Johns Polychrome,4,1200,1300,100,1,1,1
730,Flora Vista,Toadlena Black-on-white,1,975,1125,150,1,1,1
730,Flora Vista,"Type, Undifferentiated",3796,200,1900,1700,0,0,0
730,Flora Vista,"White ware, Undifferentiated",762,550,1900,1350,0,0,1
730,Flora Vista,Wingate Black-on-red,2,1050,1225,175,1,1,1
730,Flora Vista,Wingate Polychrome,3,1100,1225,125,1,1,1
733,Jaquez,Blue Shale Corrugated,5,925,1150,225,0,0,0
733,Jaquez,Bluff Black-on-red,7,800,925,125,1,1,1
733,Jaquez,Brimhall Black-on-white,9,1040,1150,110,1,1,1
733,Jaquez,Burnham Black-on-white,2,860,1000,140,1,1,1
733,Jaquez,Captain Tom Corrugated,1,890,1000,110,0,1,0
733,Jaquez,Chaco Black-on-white,33,1075,1150,75,1,1,1
733,Jaquez,Chaco Corrugated,1,1050,1100,50,0,1,0
733,Jaquez,Chaco-McElmo Black-on-white (carbon paint),6,1090,1175,85,1,1,1
733,Jaquez,Chapin Gray,4,575,980,405,0,0,0
733,Jaquez,Chuska Black-on-white,14,1040,1125,85,1,1,1
733,Jaquez,Chuska Indented Corrugated Gray,15,1040,1300,260,0,0,0
733,Jaquez,"Cibola PII/PIII White Ware, Type Undifferentiated",1,1000,1300,300,1,1,1
733,Jaquez,"Cibola White Ware, Undifferentiated",1,550,1325,775,0,1,1
733,Jaquez,"Corrugated Gray Ware, Undifferentiated",36,800,1400,600,0,0,0
733,Jaquez,Cortez Black-on-white,37,880,1060,180,1,1,1
733,Jaquez,Deadmans (La Plata) Black-on-red,5,880,1050,170,1,1,1
733,Jaquez,Dolores Corrugated,5,1100,1200,100,0,1,0
733,Jaquez,Drolet Black-on-white,1,900,1000,100,1,1,1
733,Jaquez,Escavada Black-on-white,53,1000,1100,100,1,1,1
733,Jaquez,Gallup Black-on-white,89,1040,1150,110,1,1,1
733,Jaquez,"Gray Ware, Undifferentiated",1,400,1400,1000,0,0,0
733,Jaquez,Kiatuthlanna Black-on-white,5,850,925,75,1,1,1
733,Jaquez,Mancos Black-on-white,246,980,1180,200,1,1,1
733,Jaquez,Mancos Corrugated,19,920,1180,260,0,0,0
733,Jaquez,Mancos Gray,1,880,1060,180,0,1,0
733,Jaquez,McElmo Black-on-white,127,1060,1260,200,1,1,1
733,Jaquez,Mesa Verde Black-on-white,116,1180,1280,100,1,1,1
733,Jaquez,"Mesa Verde BMIII/PI White Ware, Type Undifferentiated",2,575,920,345,0,1,1
733,Jaquez,Mesa Verde Corrugated,9,1100,1280,180,0,1,0
733,Jaquez,"Mesa Verde Corrugated Gray Ware, Undifferentiated",106,920,1280,360,0,0,0
733,Jaquez,"Mesa Verde Gray ware, Undifferentiated",23,575,1280,705,0,0,0
733,Jaquez,"Mesa Verde PII/PIII White Ware, Type Undifferentiated",26,920,1280,360,0,1,1
733,Jaquez,"Mesa Verde White Ware, Undifferentiated",14,575,1280,705,0,1,1
733,Jaquez,Moccasin Gray,3,800,980,180,0,1,0
733,Jaquez,"Mogollon Corrugated, Red-slipped",1,1000,1400,400,0,0,0
733,Jaquez,Nava Black-on-white,1,1100,1275,175,1,1,1
733,Jaquez,Newcomb Black-on-white,6,875,1000,125,1,1,1
733,Jaquez,"PI White Ware, Type Undifferentiated",1,700,900,200,1,1,1
733,Jaquez,Piedra Black-on-white,1,800,920,120,1,1,1
733,Jaquez,"PII Gray Rim, Type Undifferentiated",22,900,1100,200,0,1,0
733,Jaquez,"PII White Ware, Type Undifferentiated",8,900,1100,200,1,1,1
733,Jaquez,"PII/PIII Gray Rim, Type Undifferentiated",9,900,1300,400,0,0,0
733,Jaquez,"PIII White Ware, Type Undifferentiated",3,1100,1300,200,1,1,1
733,Jaquez,Puerco Black-on-red,6,1000,1175,175,1,1,1
733,Jaquez,Puerco Black-on-white,11,1030,1200,170,1,1,1
733,Jaquez,Red Mesa Black-on-white,11,880,1040,160,1,1,1
733,Jaquez,"Red Ware type, Undifferentiated",12,700,1700,1000,0,0,0
733,Jaquez,Reserve Black-on-white,11,1050,1200,150,1,1,1
733,Jaquez,"San Juan Red ware, Undifferentiated",1,700,1050,350,0,0,1
733,Jaquez,Showlow Red,1,1000,1100,100,0,1,0
733,Jaquez,St. Johns Black-on-red,1,1200,1300,100,1,1,1
733,Jaquez,St. Johns Polychrome,3,1200,1300,100,1,1,1
733,Jaquez,Taylor Black-on-white,6,1000,1100,100,1,1,1
733,Jaquez,Toadlena Black-on-white,22,975,1125,150,1,1,1
733,Jaquez,Tusayan Black-on-red,2,1045,1240,195,1,1,1
733,Jaquez,"Type, Undifferentiated",1325,200,1900,1700,0,0,0
733,Jaquez,"Undecorated Type, Undifferentiated",3,200,1900,1700,0,0,0
733,Jaquez,"White Mountain type, Type Undifferentiated; Early",12,1000,1300,300,0,0,1
733,Jaquez,"White ware, Undifferentiated",532,550,1900,1350,0,0,1
733,Jaquez,Wingate Black-on-red,5,1050,1225,175,1,1,1
733,Jaquez,Wingate Polychrome,7,1100,1225,125,1,1,1
734,Fort Wingate,Chaco Black-on-white,2,1075,1150,75,1,1,1
734,Fort Wingate,Chuska Black-on-white,1,1040,1125,85,1,1,1
734,Fort Wingate,"Chuska White Ware type, Undifferentiated",1,800,1300,500,0,1,1
734,Fort Wingate,"Cibola Black-on-white, Undifferentiated",5,550,1325,775,0,1,1
734,Fort Wingate,Cibola Clapboard Corrugated Gray,44,900,1100,200,0,1,0
734,Fort Wingate,"Cibola Corrugated Gray Ware, Undifferentiated",1,900,1400,500,0,0,0
734,Fort Wingate,Cibola Indented Corrugated Gray,22,1040,1400,360,0,0,0
734,Fort Wingate,Cibola Neckbanded Gray,27,850,1025,175,0,1,0
734,Fort Wingate,Cibola Plain Gray,221,550,1040,490,0,0,0
734,Fort Wingate,Escavada Black-on-white,6,1000,1100,100,1,1,1
734,Fort Wingate,Escavada-Puerco Black-on-white,11,1000,1100,100,1,1,1
734,Fort Wingate,Gallup Black-on-white,2,1040,1150,110,1,1,1
734,Fort Wingate,Naschitti Black-on-white,1,900,1000,100,1,1,1
734,Fort Wingate,Puerco Black-on-red,1,1000,1175,175,1,1,1
734,Fort Wingate,Red Mesa Black-on-white,133,880,1040,160,1,1,1
734,Fort Wingate,St. Johns Polychrome,1,1200,1300,100,1,1,1
734,Fort Wingate,Tularosa Black-on-white,1,1180,1300,120,1,1,1
734,Fort Wingate,"White Mountain type, Type Undifferentiated; Early",3,1000,1300,300,0,0,1
734,Fort Wingate,"White ware, Undifferentiated",35,550,1900,1350,0,0,1
734,Fort Wingate,"Wide Neckbanded Gray Ware, Type Undifferentiated",22,850,925,75,0,1,0
734,Fort Wingate,Wingate Black-on-red,13,1050,1225,175,1,1,1
734,Fort Wingate,Wingate Polychrome,1,1100,1225,125,1,1,1
735,Newcomb Community,Bennett Gray,1,700,850,150,0,1,0
735,Newcomb Community,Blue Shale Corrugated,6,925,1150,225,0,0,0
735,Newcomb Community,Captain Tom Corrugated,2,890,1000,110,0,1,0
735,Newcomb Community,Chuska Black-on-white,4,1040,1125,85,1,1,1
735,Newcomb Community,Chuska Indented Corrugated Gray,86,1040,1300,260,0,0,0
735,Newcomb Community,"Chuska White Ware type, Undifferentiated",18,800,1300,500,0,1,1
735,Newcomb Community,"Cibola Black-on-white, Undifferentiated",3,550,1325,775,0,1,1
735,Newcomb Community,Dogoszhi Black-on-white,1,1040,1210,170,1,1,1
735,Newcomb Community,Escavada-Puerco Black-on-white,1,1000,1100,100,1,1,1
735,Newcomb Community,Gallup Black-on-white,3,1040,1150,110,1,1,1
735,Newcomb Community,Mancos Corrugated,1,920,1180,260,0,0,0
735,Newcomb Community,McElmo Black-on-white,2,1060,1260,200,1,1,1
735,Newcomb Community,Newcomb Black-on-white,3,875,1000,125,1,1,1
735,Newcomb Community,"San Juan Red ware, Undifferentiated",1,700,1050,350,0,0,1
735,Newcomb Community,Sosi Black-on-white,1,1070,1180,110,1,1,1
735,Newcomb Community,Taylor Black-on-white,1,1000,1100,100,1,1,1
735,Newcomb Community,Toadlena Black-on-white,3,975,1125,150,1,1,1
735,Newcomb Community,"White ware, Undifferentiated",2,550,1900,1350,0,0,1
743,Twin Angels,Blue Shale Corrugated,84,925,1150,225,0,0,0
743,Twin Angels,Brimhall Black-on-white,3,1040,1150,110,1,1,1
743,Twin Angels,Captain Tom Corrugated,8,890,1000,110,0,1,0
743,Twin Angels,Chaco Black-on-white,14,1075,1150,75,1,1,1
743,Twin Angels,Chaco Corrugated,34,1050,1100,50,0,1,0
743,Twin Angels,Chaco-McElmo Black-on-white (carbon paint),5,1090,1175,85,1,1,1
743,Twin Angels,Chuska Black-on-white,5,1040,1125,85,1,1,1
743,Twin Angels,"Chuska White Ware type, Undifferentiated",1,800,1300,500,0,1,1
743,Twin Angels,"Cibola Corrugated Gray Ware, Undifferentiated",2,900,1400,500,0,0,0
743,Twin Angels,"Cibola PII Gray Ware, Type Undifferentiated",21,950,1100,150,0,1,0
743,Twin Angels,Coolidge Corrugated,20,1050,1100,50,0,1,0
743,Twin Angels,"Corrugated Gray Ware, Undifferentiated",3,800,1400,600,0,0,0
743,Twin Angels,Cortez Black-on-white,2,880,1060,180,1,1,1
743,Twin Angels,Dinetah Gray,6,1500,1750,250,0,0,0
743,Twin Angels,Escavada Black-on-white,22,1000,1100,100,1,1,1
743,Twin Angels,Gallup Black-on-white,12,1040,1150,110,1,1,1
743,Twin Angels,Hunter Corrugated,12,1100,1300,200,0,1,0
743,Twin Angels,Mancos Black-on-white,2,980,1180,200,1,1,1
743,Twin Angels,Mancos Corrugated,4,920,1180,260,0,0,0
743,Twin Angels,McElmo Black-on-white,18,1060,1260,200,1,1,1
743,Twin Angels,Nava Black-on-white,20,1100,1275,175,1,1,1
743,Twin Angels,Newcomb Black-on-white,9,875,1000,125,1,1,1
743,Twin Angels,Newcomb Corrugated,9,875,950,75,0,1,0
743,Twin Angels,"PII Gray Rim, Type Undifferentiated",49,900,1100,200,0,1,0
743,Twin Angels,"PII White Ware, Type Undifferentiated",38,900,1100,200,1,1,1
743,Twin Angels,"Plain Gray Ware, Undifferentiated",14,500,1300,800,0,0,0
743,Twin Angels,Puerco Black-on-red,3,1000,1175,175,1,1,1
743,Twin Angels,Puerco Black-on-white,2,1030,1200,170,1,1,1
743,Twin Angels,Taylor Black-on-white,4,1000,1100,100,1,1,1
743,Twin Angels,Toadlena Black-on-white,1,975,1125,150,1,1,1
743,Twin Angels,Tusayan Black-on-red,2,1045,1240,195,1,1,1
743,Twin Angels,"White Mountain type, Type Undifferentiated; Early",1,1000,1300,300,0,0,1
743,Twin Angels,"White ware, Undifferentiated",72,550,1900,1350,0,0,1
743,Twin Angels,Wingate Black-on-red,1,1050,1225,175,1,1,1
745,Lizard House--Cebolleta Mesa,Cebolleta Black-on-white,9,1000,1200,200,1,1,1
745,Lizard House--Cebolleta Mesa,Cibola Indented Corrugated Gray,92,1040,1400,360,0,0,0
745,Lizard House--Cebolleta Mesa,Cibola Plain Gray,4,550,1040,490,0,0,0
745,Lizard House--Cebolleta Mesa,"Cibola White Ware, Undifferentiated",24,550,1325,775,0,1,1
745,Lizard House--Cebolleta Mesa,Socorro Black-on-white,2,1050,1300,250,1,1,1
745,Lizard House--Cebolleta Mesa,St. Johns Black-on-red,3,1200,1300,100,1,1,1
745,Lizard House--Cebolleta Mesa,St. Johns Polychrome,4,1200,1300,100,1,1,1
745,Lizard House--Cebolleta Mesa,Tularosa Black-on-white,15,1180,1300,120,1,1,1
745,Lizard House--Cebolleta Mesa,"White Mountain type, Type Undifferentiated; Early",12,1000,1300,300,0,0,1
750,Skunk Springs,Abajo Red-on-orange,3,760,880,120,1,1,1
750,Skunk Springs,Bennett Gray,41,700,850,150,0,1,0
750,Skunk Springs,Blue Shale Corrugated,124,925,1150,225,0,0,0
750,Skunk Springs,Brimhall Black-on-white,51,1040,1150,110,1,1,1
750,Skunk Springs,Burnham Black-on-white,12,860,1000,140,1,1,1
750,Skunk Springs,Captain Tom Corrugated,20,890,1000,110,0,1,0
750,Skunk Springs,Chuska Black-on-white,10,1040,1125,85,1,1,1
750,Skunk Springs,Chuska Indented Corrugated Gray,84,1040,1300,260,0,0,0
750,Skunk Springs,"Chuska Orange Ware, Undifferentiated",1,825,875,50,1,1,1
750,Skunk Springs,"Chuska Plain Gray Ware, Type Undifferentiated",10,700,925,225,0,0,0
750,Skunk Springs,"Chuska White Ware type, Undifferentiated",7,800,1300,500,0,1,1
750,Skunk Springs,Cibola Indented Corrugated Gray,14,1040,1400,360,0,0,0
750,Skunk Springs,Cibola Plain Gray,3,550,1040,490,0,0,0
750,Skunk Springs,Coolidge Corrugated,6,1050,1100,50,0,1,0
750,Skunk Springs,"Corrugated Gray Ware, Undifferentiated",3,800,1400,600,0,0,0
750,Skunk Springs,Cortez Black-on-white,3,880,1060,180,1,1,1
750,Skunk Springs,Crozier Black-on-white,6,800,900,100,1,1,1
750,Skunk Springs,Crumbled House Black-on-white,11,1150,1300,150,1,1,1
750,Skunk Springs,Deadmans (La Plata) Black-on-red,8,880,1050,170,1,1,1
750,Skunk Springs,Drolet Black-on-white,1,900,1000,100,1,1,1
750,Skunk Springs,Escavada Black-on-white,2,1000,1100,100,1,1,1
750,Skunk Springs,Escavada-Puerco Black-on-white,3,1000,1100,100,1,1,1
750,Skunk Springs,Gallup Black-on-white,19,1040,1150,110,1,1,1
750,Skunk Springs,Gray Hills Banded,25,850,950,100,0,1,0
750,Skunk Springs,"Historic Zuni type, Undifferentiated",1,1680,1900,220,1,1,1
750,Skunk Springs,Holbrook Black-on-white,3,1050,1150,100,1,1,1
750,Skunk Springs,Hunter Corrugated,47,1100,1300,200,0,1,0
750,Skunk Springs,Kana-a Black-on-white,1,825,1000,175,1,1,1
750,Skunk Springs,McElmo Black-on-white,8,1060,1260,200,1,1,1
750,Skunk Springs,Mesa Verde Black-on-white,12,1180,1280,100,1,1,1
750,Skunk Springs,"Mesa Verde White Ware, Undifferentiated",6,575,1280,705,0,1,1
750,Skunk Springs,Naschitti Black-on-white,11,900,1000,100,1,1,1
750,Skunk Springs,Nava Black-on-white,54,1100,1275,175,1,1,1
750,Skunk Springs,Newcomb Black-on-white,38,875,1000,125,1,1,1
750,Skunk Springs,Newcomb Corrugated,13,875,950,75,0,1,0
750,Skunk Springs,Pena Black-on-white,6,800,900,100,1,1,1
750,Skunk Springs,"Quemado Gray Ware, Undifferentiated",1,1540,1900,360,0,0,0
750,Skunk Springs,Red Mesa Black-on-white,12,880,1040,160,1,1,1
750,Skunk Springs,"Red Ware type, Undifferentiated",3,700,1700,1000,0,0,0
750,Skunk Springs,"San Juan Red ware, Undifferentiated",2,700,1050,350,0,0,1
750,Skunk Springs,Sheep Springs Gray,10,800,850,50,0,1,0
750,Skunk Springs,Sosi Black-on-white,2,1070,1180,110,1,1,1
750,Skunk Springs,St. Johns Polychrome,9,1200,1300,100,1,1,1
750,Skunk Springs,Taylor Black-on-white,14,1000,1100,100,1,1,1
750,Skunk Springs,Toadlena Black-on-white,26,975,1125,150,1,1,1
750,Skunk Springs,Tocito Gray,3,825,875,50,0,1,0
750,Skunk Springs,"Tsegi Orange Ware, Undifferentiated",1,1000,1300,300,1,0,1
750,Skunk Springs,Tularosa Black-on-white,4,1180,1300,120,1,1,1
750,Skunk Springs,Tunicha Black-on-white,8,850,900,50,1,1,1
750,Skunk Springs,Wetherill Black-on-white,3,1060,1180,120,1,1,1
750,Skunk Springs,"White Mountain type, Type Undifferentiated; Early",2,1000,1300,300,0,0,1
750,Skunk Springs,Wingate Black-on-red,7,1050,1225,175,1,1,1
754,Crumbled House,Brimhall Black-on-white,1,1040,1150,110,1,1,1
754,Crumbled House,Chuska Indented Corrugated Gray,116,1040,1300,260,0,0,0
754,Crumbled House,"Chuska Plain Gray Ware, Type Undifferentiated",4,700,925,225,0,0,0
754,Crumbled House,"Cibola Black-on-white, Undifferentiated",6,550,1325,775,0,1,1
754,Crumbled House,Cibola Indented Corrugated Gray,6,1040,1400,360,0,0,0
754,Crumbled House,Crumbled House Black-on-white,13,1150,1300,150,1,1,1
754,Crumbled House,Gallup Black-on-white,2,1040,1150,110,1,1,1
754,Crumbled House,McElmo Black-on-white,10,1060,1260,200,1,1,1
754,Crumbled House,Nava Black-on-white,24,1100,1275,175,1,1,1
754,Crumbled House,St. Johns Polychrome,3,1200,1300,100,1,1,1
754,Crumbled House,Tularosa Black-on-white,1,1180,1300,120,1,1,1
754,Crumbled House,"White Mountain type, Type Undifferentiated; Early",4,1000,1300,300,0,0,1
754,Crumbled House,Wingate Black-on-red,2,1050,1225,175,1,1,1
811,LA 8240,Blue Shale Corrugated,32,925,1150,225,0,0,0
811,LA 8240,Brimhall Black-on-white,50,1040,1150,110,1,1,1
811,LA 8240,Captain Tom Corrugated,2,890,1000,110,0,1,0
811,LA 8240,Chaco Corrugated,8,1050,1100,50,0,1,0
811,LA 8240,"Cibola Corrugated Gray Ware, Undifferentiated",8,900,1400,500,0,0,0
811,LA 8240,Coolidge Corrugated,2,1050,1100,50,0,1,0
811,LA 8240,Crozier Black-on-white,2,800,900,100,1,1,1
811,LA 8240,Crumbled House Black-on-white,6,1150,1300,150,1,1,1
811,LA 8240,Gallup Black-on-white,4,1040,1150,110,1,1,1
811,LA 8240,Hunter Corrugated,20,1100,1300,200,0,1,0
811,LA 8240,McElmo Black-on-white,19,1060,1260,200,1,1,1
811,LA 8240,Mesa Verde Black-on-white,16,1180,1280,100,1,1,1
811,LA 8240,Naschitti Black-on-white,10,900,1000,100,1,1,1
811,LA 8240,Nava Black-on-white,1,1100,1275,175,1,1,1
811,LA 8240,Newcomb Corrugated,4,875,950,75,0,1,0
811,LA 8240,Red Mesa Black-on-white,4,880,1040,160,1,1,1
811,LA 8240,St. Johns Polychrome,4,1200,1300,100,1,1,1
811,LA 8240,Taylor Black-on-white,12,1000,1100,100,1,1,1
811,LA 8240,Wetherill Black-on-white,2,1060,1180,120,1,1,1
811,LA 8240,"White Mountain type, Type Undifferentiated; Early",4,1000,1300,300,0,0,1
811,LA 8240,"White ware, Undifferentiated",2,550,1900,1350,0,0,1
811,LA 8240,Wingate Black-on-red,8,1050,1225,175,1,1,1
811,LA 8240,Wingate Polychrome,20,1100,1225,125,1,1,1
824,Salmon,Abajo Red-on-orange,15,760,880,120,1,1,1
824,Salmon,Black Mesa Black-on-white,19,1000,1100,100,1,1,1
824,Salmon,Blue Shale Corrugated,93,925,1150,225,0,0,0
824,Salmon,Bluff Black-on-red,2,800,925,125,1,1,1
824,Salmon,Brimhall Black-on-white,24,1040,1150,110,1,1,1
824,Salmon,Burnham Black-on-white,1,860,1000,140,1,1,1
824,Salmon,Cameron Polychrome,8,1040,1170,130,1,1,1
824,Salmon,Captain Tom Corrugated,12,890,1000,110,0,1,0
824,Salmon,Chaco Black-on-white,1670,1075,1150,75,1,1,1
824,Salmon,Chaco Corrugated,9,1050,1100,50,0,1,0
824,Salmon,Chaco-McElmo Black-on-white (carbon paint),789,1090,1175,85,1,1,1
824,Salmon,Chapin Gray,1,575,980,405,0,0,0
824,Salmon,Chuska Black-on-white,136,1040,1125,85,1,1,1
824,Salmon,"Chuska Corrugated Gray Ware, Undifferentiated",2656,890,1300,410,0,0,0
824,Salmon,"Chuska Plain Gray Ware, Type Undifferentiated",14,700,925,225,0,0,0
824,Salmon,"Cibola Corrugated Gray Ware, Undifferentiated",113,900,1400,500,0,0,0
824,Salmon,Citadel Polychrome,30,1040,1200,160,1,1,1
824,Salmon,"Corrugated Gray Ware, Undifferentiated",9209,800,1400,600,0,0,0
824,Salmon,Cortez Black-on-white,57,880,1060,180,1,1,1
824,Salmon,Crumbled House Black-on-white,18,1150,1300,150,1,1,1
824,Salmon,Deadmans (La Plata) Black-on-red,9,880,1050,170,1,1,1
824,Salmon,Dogoszhi Black-on-white,7,1040,1210,170,1,1,1
824,Salmon,Escavada Black-on-white,2805,1000,1100,100,1,1,1
824,Salmon,Flagstaff Black-on-white,1,1150,1220,70,1,1,1
824,Salmon,Gallup Black-on-white,40884,1040,1150,110,1,1,1
824,Salmon,Hunter Corrugated,5,1100,1300,200,0,1,0
824,Salmon,Kiatuthlanna Black-on-white,5,850,925,75,1,1,1
824,Salmon,Lino Gray (Tusayan),1,550,950,400,0,0,0
824,Salmon,Mancos Black-on-white,17334,980,1180,200,1,1,1
824,Salmon,Mancos Gray,3,880,1060,180,0,1,0
824,Salmon,McElmo Black-on-white,8391,1060,1260,200,1,1,1
824,Salmon,McElmo/Mesa Verde Black-on-white,83,1060,1280,220,1,1,1
824,Salmon,Medicine Black-on-red,2,1040,1170,130,1,1,1
824,Salmon,Mesa Verde Black-on-white,28993,1180,1280,100,1,1,1
824,Salmon,"Mesa Verde Corrugated Gray Ware, Undifferentiated",22438,920,1280,360,0,0,0
824,Salmon,"Mogollon Brown ware, Undifferentiated",11,900,1400,500,0,0,0
824,Salmon,"Mogollon Corrugated Brown Ware, Undifferentiated",2,800,1400,600,0,0,0
824,Salmon,"Mogollon Patterned Corrugated Brown Ware, Smudged",2,1000,1400,400,0,0,0
824,Salmon,"Mogollon Plain Brown Ware, Smudged",151,300,1400,1100,0,0,0
824,Salmon,Nava Black-on-white,46,1100,1275,175,1,1,1
824,Salmon,Newcomb Black-on-white,8,875,1000,125,1,1,1
824,Salmon,Newcomb Corrugated,7,875,950,75,0,1,0
824,Salmon,Padre Black-on-white,2,1100,1250,150,1,1,1
824,Salmon,Piedra Black-on-white,1,800,920,120,1,1,1
824,Salmon,Pinedale Black-on-red,1,1280,1330,50,1,1,1
824,Salmon,"Plain Gray Ware, Undifferentiated",2906,500,1300,800,0,0,0
824,Salmon,Puerco Black-on-red,103,1000,1175,175,1,1,1
824,Salmon,Puerco Black-on-white,126,1030,1200,170,1,1,1
824,Salmon,Red Mesa Black-on-white,71,880,1040,160,1,1,1
824,Salmon,Reserve Black-on-white,25,1050,1200,150,1,1,1
824,Salmon,Showlow Red,40,1000,1100,100,0,1,0
824,Salmon,Showlow Red Corrugated,1,1030,1280,250,0,0,0
824,Salmon,Snowflake Black-on-white,1,1100,1275,175,1,1,1
824,Salmon,Sosi Black-on-white,48,1070,1180,110,1,1,1
824,Salmon,St. Johns Black-on-red,130,1200,1300,100,1,1,1
824,Salmon,St. Johns Polychrome,239,1200,1300,100,1,1,1
824,Salmon,Taylor Black-on-white,12,1000,1100,100,1,1,1
824,Salmon,Toadlena Black-on-white,107,975,1125,150,1,1,1
824,Salmon,Tularosa Black-on-white,4,1180,1300,120,1,1,1
824,Salmon,Tusayan Black-on-red,1,1045,1240,195,1,1,1
824,Salmon,Tusayan Black-on-white,58,1200,1300,100,1,1,1
824,Salmon,Tusayan Polychrome,11,1110,1320,210,1,1,1
824,Salmon,Wetherill Black-on-white,1828,1060,1180,120,1,1,1
824,Salmon,Wingate Black-on-red,1105,1050,1225,175,1,1,1
824,Salmon,Wingate Polychrome,99,1100,1225,125,1,1,1
824,Salmon,Woodruff Brown,6,500,1100,600,0,0,0
824,Salmon,Woodruff Red,2,400,1100,700,0,0,0
824,Salmon,Woodruff Smudged,14,500,1100,600,0,0,0
903,Kello Blancett,"Indented Corrugated Gray Ware, Undifferentiated",147,950,1400,450,0,0,0
903,Kello Blancett,Mancos Black-on-white,2,980,1180,200,1,1,1
903,Kello Blancett,McElmo Black-on-white,16,1060,1260,200,1,1,1
903,Kello Blancett,McElmo/Mesa Verde Black-on-white,29,1060,1280,220,1,1,1
903,Kello Blancett,Mesa Verde Black-on-white,29,1180,1280,100,1,1,1
903,Kello Blancett,"Plain Gray Ware, Undifferentiated",18,500,1300,800,0,0,0
903,Kello Blancett,Puerco Black-on-white,1,1030,1200,170,1,1,1
903,Kello Blancett,Tsegi Orange,7,1250,1300,50,1,1,1
903,Kello Blancett,Wetherill Black-on-white,3,1060,1180,120,1,1,1
903,Kello Blancett,"White Mountain type, Type Undifferentiated; Early",1,1000,1300,300,0,0,1
903,Kello Blancett,"White ware, Undifferentiated",42,550,1900,1350,0,0,1
903,Kello Blancett,Wingate Black-on-red,2,1050,1225,175,1,1,1
903,Kello Blancett,Wingate Polychrome,1,1100,1225,125,1,1,1
906,Morris' Old Fort,"Indented Corrugated Gray Ware, Undifferentiated",135,950,1400,450,0,0,0
906,Morris' Old Fort,McElmo Black-on-white,5,1060,1260,200,1,1,1
906,Morris' Old Fort,McElmo/Mesa Verde Black-on-white,6,1060,1280,220,1,1,1
906,Morris' Old Fort,Mesa Verde Black-on-white,7,1180,1280,100,1,1,1
906,Morris' Old Fort,"Plain Gray Ware, Undifferentiated",8,500,1300,800,0,0,0
906,Morris' Old Fort,"Red Ware type, Undifferentiated",1,700,1700,1000,0,0,0
906,Morris' Old Fort,St. Johns Polychrome,1,1200,1300,100,1,1,1
906,Morris' Old Fort,"White ware, Undifferentiated",14,550,1900,1350,0,0,1
964,Hinkson Ranch,"Cibola Black-on-white, Undifferentiated",3060,550,1325,775,0,1,1
964,Hinkson Ranch,Cibola Clapboard Corrugated Gray,77,900,1100,200,0,1,0
964,Hinkson Ranch,Cibola Indented Corrugated Gray,6794,1040,1400,360,0,0,0
964,Hinkson Ranch,Cibola Plain Corrugated Gray,20,900,1100,200,0,1,0
964,Hinkson Ranch,Cibola Plain Gray,973,550,1040,490,0,0,0
964,Hinkson Ranch,Escavada Black-on-white,50,1000,1100,100,1,1,1
964,Hinkson Ranch,Gallup Black-on-white,26,1040,1150,110,1,1,1
964,Hinkson Ranch,Heshotauthla Black-on-red or Polychrome,3,1275,1450,175,1,1,1
964,Hinkson Ranch,Kiatuthlanna Black-on-white,50,850,925,75,1,1,1
964,Hinkson Ranch,Kwakina Polychrome,5,1280,1450,170,1,1,1
964,Hinkson Ranch,Lino Gray (Tusayan),84,550,950,400,0,0,0
964,Hinkson Ranch,"Mogollon Corrugated Brown Ware, Undifferentiated",309,800,1400,600,0,0,0
964,Hinkson Ranch,Mogollon Plain Brown Ware,200,300,1400,1100,0,0,0
964,Hinkson Ranch,Mogollon Plain Corrugated Brown Ware,93,900,1400,500,0,0,0
964,Hinkson Ranch,"Mogollon Plain Corrugated Brown Ware, Smudged",37,900,1400,500,0,0,0
964,Hinkson Ranch,Pinedale Black-on-white,71,1270,1320,50,1,1,1
964,Hinkson Ranch,Pinedale Polychrome,6,1290,1330,40,1,1,1
964,Hinkson Ranch,Puerco Black-on-red,15,1000,1175,175,1,1,1
964,Hinkson Ranch,Puerco Black-on-white,149,1030,1200,170,1,1,1
964,Hinkson Ranch,Red Mesa Black-on-white,44,880,1040,160,1,1,1
964,Hinkson Ranch,"Red Ware type, Undifferentiated",1524,700,1700,1000,0,0,0
964,Hinkson Ranch,Reserve Black-on-white,67,1050,1200,150,1,1,1
964,Hinkson Ranch,Springerville Polychrome,24,1250,1300,50,1,1,1
964,Hinkson Ranch,St. Johns Black-on-red,589,1200,1300,100,1,1,1
964,Hinkson Ranch,St. Johns Polychrome,757,1200,1300,100,1,1,1
964,Hinkson Ranch,Tularosa Black-on-white,1982,1180,1300,120,1,1,1
964,Hinkson Ranch,"Type, Undifferentiated",23,200,1900,1700,0,0,0
964,Hinkson Ranch,Wingate Black-on-red,126,1050,1225,175,1,1,1
964,Hinkson Ranch,Wingate Polychrome,124,1100,1225,125,1,1,1
971,Kin Cheops II,"Cibola Black-on-white, Undifferentiated",5,550,1325,775,0,1,1
971,Kin Cheops II,"Cibola Corrugated Gray Ware, Undifferentiated",2,900,1400,500,0,0,0
971,Kin Cheops II,"Cibola White Ware, Undifferentiated",6,550,1325,775,0,1,1
971,Kin Cheops II,Klagetoh Black-on-white,2,1250,1300,50,1,1,1
971,Kin Cheops II,Mogollon Plain Corrugated Brown Ware,16,900,1400,500,0,0,0
971,Kin Cheops II,"Mogollon Plain Corrugated Brown Ware, Smudged",2,900,1400,500,0,0,0
971,Kin Cheops II,Puerco Black-on-red,1,1000,1175,175,1,1,1
971,Kin Cheops II,Puerco Black-on-white,35,1030,1200,170,1,1,1
971,Kin Cheops II,Springerville Polychrome,2,1250,1300,50,1,1,1
971,Kin Cheops II,St. Johns Polychrome,6,1200,1300,100,1,1,1
971,Kin Cheops II,Tularosa Black-on-white,10,1180,1300,120,1,1,1
971,Kin Cheops II,"White Mountain type, Type Undifferentiated; Early",7,1000,1300,300,0,0,1
977,Eagle Crag,Awatovi Black-on-yellow,2,1325,1375,50,1,1,1
977,Eagle Crag,Bidahochi Black-on-white,4,1325,1400,75,1,1,1
977,Eagle Crag,"Black-on-gray, Undifferentiated",1,550,1300,750,0,1,1
977,Eagle Crag,"Cibola Black-on-white, Undifferentiated",2,550,1325,775,0,1,1
977,Eagle Crag,Dogoszhi Black-on-white,4,1040,1210,170,1,1,1
977,Eagle Crag,Flagstaff Black-on-white,1,1150,1220,70,1,1,1
977,Eagle Crag,Fourmile Polychrome,1,1325,1400,75,1,1,1
977,Eagle Crag,Gallup Black-on-white,2,1040,1150,110,1,1,1
977,Eagle Crag,Heshotauthla Black-on-red,1,1275,1450,175,1,1,1
977,Eagle Crag,Holbrook B Black-on-white,3,1050,1150,100,1,1,1
977,Eagle Crag,Holbrook Black-on-white,2,1050,1150,100,1,1,1
977,Eagle Crag,Jeddito Polychrome,1,1250,1300,50,1,1,1
977,Eagle Crag,Kana'a Neckbanded,1,865,1060,195,0,1,0
977,Eagle Crag,Kayenta Black-on-white,3,1250,1300,50,1,1,1
977,Eagle Crag,Kiet Siel Polychrome,1,1250,1320,70,1,1,1
977,Eagle Crag,Kokop Black-on-orange,4,1300,1350,50,1,1,1
977,Eagle Crag,Leupp Black-on-white,5,1200,1250,50,1,1,1
977,Eagle Crag,"Little Colorado Corrugated Gray Ware, Undifferentiated",2,1050,1250,200,0,1,0
977,Eagle Crag,"Little Colorado Gray Ware, Undifferentiated",1,850,1300,450,0,0,0
977,Eagle Crag,"Little Colorado Plain Gray, Undifferentiated",1,550,1040,490,0,0,0
977,Eagle Crag,"Little Colorado White Ware, Undifferentiated",7,825,1250,425,0,1,1
977,Eagle Crag,Moenkopi Corrugated,45,1130,1250,120,0,1,0
977,Eagle Crag,"Mogollon Corrugated, Red-slipped",1,1000,1400,400,0,0,0
977,Eagle Crag,Padre Black-on-white,4,1100,1250,150,1,1,1
977,Eagle Crag,Pinedale Polychrome,3,1290,1330,40,1,1,1
977,Eagle Crag,"Plain Gray Ware, Undifferentiated",56,500,1300,800,0,0,0
977,Eagle Crag,Puerco Black-on-red,1,1000,1175,175,1,1,1
977,Eagle Crag,St. Johns Black-on-red or Polychrome,1,1200,1300,100,1,1,1
977,Eagle Crag,"Tsegi Orange Ware, Undifferentiated",3,1000,1300,300,1,0,1
977,Eagle Crag,Tusayan Black-on-red,1,1045,1240,195,1,1,1
977,Eagle Crag,Tusayan Black-on-white,15,1200,1300,100,1,1,1
977,Eagle Crag,Tusayan Corrugated,37,1020,1275,255,0,0,0
977,Eagle Crag,"Tusayan White Ware, Undifferentiated",1,825,1300,475,0,1,1
977,Eagle Crag,Walnut Black-on-white,2,1100,1250,150,1,1,1
977,Eagle Crag,"White Mountain type, Type Undifferentiated; Early",1,1000,1300,300,0,0,1
977,Eagle Crag,"White Mountain type, Type Undifferentiated; Late",1,1280,1425,145,0,1,1
977,Eagle Crag,"White ware, Undifferentiated",8,550,1900,1350,0,0,1
977,Eagle Crag,Wingate Polychrome,1,1100,1225,125,1,1,1
989,Kinlichee,Abajo Red-on-orange,1,760,880,120,1,1,1
989,Kinlichee,Black Mesa Black-on-white,91,1000,1100,100,1,1,1
989,Kinlichee,"Brown Ware, Undifferentiated",60,500,1450,950,0,0,0
989,Kinlichee,Cibola Indented Corrugated Gray,674,1040,1400,360,0,0,0
989,Kinlichee,Cibola Moenkopi Style Corrugated Gray,89,1130,1300,170,0,1,0
989,Kinlichee,Cibola Narrow Fillet Gray,3,950,1100,150,0,1,0
989,Kinlichee,Cibola Narrow Neckbanded Gray,742,900,1025,125,0,1,0
989,Kinlichee,Cibola Plain Gray,521,550,1040,490,0,0,0
989,Kinlichee,Cibola Tooled,177,850,950,100,0,1,0
989,Kinlichee,"Cibola White Ware, Undifferentiated",463,550,1325,775,0,1,1
989,Kinlichee,Cibola Wide Neckbanded,175,850,925,75,0,1,0
989,Kinlichee,"Corrugated Gray Ware, Undifferentiated",226,800,1400,600,0,0,0
989,Kinlichee,Dogoszhi Black-on-white,4,1040,1210,170,1,1,1
989,Kinlichee,Escavada Black-on-white,18,1000,1100,100,1,1,1
989,Kinlichee,Flagstaff Black-on-white,30,1150,1220,70,1,1,1
989,Kinlichee,Gallup Black-on-white,126,1040,1150,110,1,1,1
989,Kinlichee,Holbrook Black-on-white,9,1050,1150,100,1,1,1
989,Kinlichee,"Indented Corrugated Gray Ware, Undifferentiated",187,950,1400,450,0,0,0
989,Kinlichee,Kana-a Black-on-white,198,825,1000,175,1,1,1
989,Kinlichee,Kiatuthlanna Black-on-white,374,850,925,75,1,1,1
989,Kinlichee,Klagetoh Black-on-white,18,1250,1300,50,1,1,1
989,Kinlichee,La Plata Black-on-white,3,550,750,200,1,1,1
989,Kinlichee,Lino Gray (Tusayan),34,550,950,400,0,0,0
989,Kinlichee,Lino Gray Fugitive Red [Cibola Series],11,550,850,300,1,0,0
989,Kinlichee,McElmo Black-on-white,6,1060,1260,200,1,1,1
989,Kinlichee,Medicine Black-on-red,1,1040,1170,130,1,1,1
989,Kinlichee,Mogollon Plain Brown Ware,3,300,1400,1100,0,0,0
989,Kinlichee,"Obliterated Corrugated Brown Ware, Undifferentiated",70,1100,1450,350,0,0,0
989,Kinlichee,"Obliterated Corrugated Gray Ware, Undifferentiated",79,1100,1400,300,0,0,0
989,Kinlichee,"PII/PIII White Ware, Type Undifferentiated",6,900,1300,400,0,1,1
989,Kinlichee,Pinedale Black-on-red,1,1280,1330,50,1,1,1
989,Kinlichee,"Plain Gray Ware, Undifferentiated",149,500,1300,800,0,0,0
989,Kinlichee,Puerco Black-on-red,25,1000,1175,175,1,1,1
989,Kinlichee,Puerco Black-on-white,495,1030,1200,170,1,1,1
989,Kinlichee,Puerco or Red Mesa Black-on-white,134,880,1200,320,0,0,1
989,Kinlichee,Red Mesa Black-on-white,434,880,1040,160,1,1,1
989,Kinlichee,Reserve Smudged,19,750,800,50,0,0,0
989,Kinlichee,"San Juan Red ware, Undifferentiated",3,700,1050,350,0,0,1
989,Kinlichee,Sosi Black-on-white,2,1070,1180,110,1,1,1
989,Kinlichee,St. Johns Black-on-red,3,1200,1300,100,1,1,1
989,Kinlichee,St. Johns Black-on-red or Polychrome,1,1200,1300,100,1,1,1
989,Kinlichee,St. Johns Polychrome,15,1200,1300,100,1,1,1
989,Kinlichee,"Tusayan Gray Ware, Undifferentiated",6,550,1285,735,0,0,0
989,Kinlichee,Tusayan Plain Gray,3469,600,1300,700,0,0,0
989,Kinlichee,Tusayan Polychrome,1,1110,1320,210,1,1,1
989,Kinlichee,Walnut Black-on-white,16,1100,1250,150,1,1,1
989,Kinlichee,White Mound Black-on-white,85,700,850,150,1,1,1
989,Kinlichee,"White Mountain type, undifferentiated",1,1000,1450,450,0,0,1
989,Kinlichee,"White ware, Undifferentiated",29,550,1900,1350,0,0,1
989,Kinlichee,Wingate Black-on-red,7,1050,1225,175,1,1,1
994,Cornfields,Black Mesa Black-on-white,5,1000,1100,100,1,1,1
994,Cornfields,Chaco Black-on-white,1,1075,1150,75,1,1,1
994,Cornfields,"Chuska White Ware type, Undifferentiated",4,800,1300,500,0,1,1
994,Cornfields,Cibola Indented Corrugated Gray,31,1040,1400,360,0,0,0
994,Cornfields,"Cibola White Ware, Undifferentiated",39,550,1325,775,0,1,1
994,Cornfields,Dogoszhi Black-on-white,3,1040,1210,170,1,1,1
994,Cornfields,Escavada Black-on-white,4,1000,1100,100,1,1,1
994,Cornfields,Flagstaff Black-on-white,4,1150,1220,70,1,1,1
994,Cornfields,Gallup Black-on-white,2,1040,1150,110,1,1,1
994,Cornfields,Holbrook B Black-on-white,2,1050,1150,100,1,1,1
994,Cornfields,Holbrook Black-on-white,2,1050,1150,100,1,1,1
994,Cornfields,Kana-a Black-on-white,1,825,1000,175,1,1,1
994,Cornfields,Kana'a Neckbanded,1,865,1060,195,0,1,0
994,Cornfields,Kayenta Black-on-white,1,1250,1300,50,1,1,1
994,Cornfields,Kiatuthlanna Black-on-white,2,850,925,75,1,1,1
994,Cornfields,Kintiel Black-on-orange,15,1275,1300,25,1,1,1
994,Cornfields,Klagetoh Black-on-white,38,1250,1300,50,1,1,1
994,Cornfields,Klagetoh Polychrome,11,1250,1325,75,1,1,1
994,Cornfields,La Plata Black-on-white,1,550,750,200,1,1,1
994,Cornfields,Leupp Black-on-white,11,1200,1250,50,1,1,1
994,Cornfields,"Little Colorado Corrugated Gray Ware, Undifferentiated",11,1050,1250,200,0,1,0
994,Cornfields,Little Colorado Indented Corrugated Gray,20,1050,1300,250,0,0,0
994,Cornfields,"Little Colorado Plain Gray, Undifferentiated",4,550,1040,490,0,0,0
994,Cornfields,"Little Colorado White Ware, Undifferentiated",34,825,1250,425,0,1,1
994,Cornfields,Mancos Black-on-white,2,980,1180,200,1,1,1
994,Cornfields,Moenkopi Corrugated,23,1130,1250,120,0,1,0
994,Cornfields,"Orange Ware, Undifferentiated",2,1000,1350,350,0,0,0
994,Cornfields,Padre Black-on-white,4,1100,1250,150,1,1,1
994,Cornfields,Pinedale Polychrome,1,1290,1330,40,1,1,1
994,Cornfields,"Plain Gray Ware, Undifferentiated",18,500,1300,800,0,0,0
994,Cornfields,Puerco Black-on-white,2,1030,1200,170,1,1,1
994,Cornfields,Red Mesa Black-on-white,3,880,1040,160,1,1,1
994,Cornfields,Reserve Black-on-white,8,1050,1200,150,1,1,1
994,Cornfields,Snowflake Black-on-white,1,1100,1275,175,1,1,1
994,Cornfields,Sosi Black-on-white,5,1070,1180,110,1,1,1
994,Cornfields,St. Johns Black-on-red,9,1200,1300,100,1,1,1
994,Cornfields,St. Johns Polychrome,107,1200,1300,100,1,1,1
994,Cornfields,"Tsegi Orange Ware, Undifferentiated",2,1000,1300,300,1,0,1
994,Cornfields,Tsegi Polychrome,1,1225,1300,75,1,1,1
994,Cornfields,Tularosa Black-on-white,39,1180,1300,120,1,1,1
994,Cornfields,Tusayan B Polychrome,1,1110,1320,210,1,1,1
994,Cornfields,Tusayan Black-on-red,1,1045,1240,195,1,1,1
994,Cornfields,Tusayan Black-on-white,11,1200,1300,100,1,1,1
994,Cornfields,Tusayan Corrugated,88,1020,1275,255,0,0,0
994,Cornfields,"Tusayan Gray Ware, Undifferentiated",15,550,1285,735,0,0,0
994,Cornfields,Tusayan Plain Gray,17,600,1300,700,0,0,0
994,Cornfields,"Tusayan White Ware, Undifferentiated",15,825,1300,475,0,1,1
994,Cornfields,Tusayan Wide Clapboard Gray,1,850,925,75,0,1,0
994,Cornfields,"Type, Undifferentiated",2,200,1900,1700,0,0,0
994,Cornfields,Walnut B Black-on-white,3,1200,1250,50,1,1,1
994,Cornfields,Walnut Black-on-white,9,1100,1250,150,1,1,1
994,Cornfields,"White Mountain type, Type Undifferentiated; Early",76,1000,1300,300,0,0,1
994,Cornfields,"White Mountain type, undifferentiated",9,1000,1450,450,0,0,1
994,Cornfields,"White ware, Undifferentiated",1,550,1900,1350,0,0,1
994,Cornfields,Wingate Black-on-red,5,1050,1225,175,1,1,1
994,Cornfields,Wingate Polychrome,26,1100,1225,125,1,1,1
1098,Tom's Rock,"Cibola Black-on-white, Undifferentiated",11,550,1325,775,0,1,1
1098,Tom's Rock,"Cibola Corrugated Gray Ware, Undifferentiated",2,900,1400,500,0,0,0
1098,Tom's Rock,Cibola Plain Gray,6,550,1040,490,0,0,0
1098,Tom's Rock,Klagetoh Black-on-white,8,1250,1300,50,1,1,1
1098,Tom's Rock,"Mogollon Plain Brown Ware, Smudged",1,300,1400,1100,0,0,0
1098,Tom's Rock,Mogollon Plain Corrugated Brown Ware,25,900,1400,500,0,0,0
1098,Tom's Rock,Puerco Black-on-red,11,1000,1175,175,1,1,1
1098,Tom's Rock,Puerco Black-on-white,15,1030,1200,170,1,1,1
1098,Tom's Rock,"Red Ware type, Undifferentiated",2,700,1700,1000,0,0,0
1098,Tom's Rock,Socorro Black-on-white,1,1050,1300,250,1,1,1
1098,Tom's Rock,Springerville Polychrome,14,1250,1300,50,1,1,1
1098,Tom's Rock,St. Johns Polychrome,2,1200,1300,100,1,1,1
1098,Tom's Rock,Tularosa Black-on-white,10,1180,1300,120,1,1,1
1098,Tom's Rock,Wingate Black-on-red,8,1050,1225,175,1,1,1
1099,Goesling,"Cibola White Ware, Undifferentiated",36,550,1325,775,0,1,1
1099,Goesling,Escavada-Puerco Black-on-white,10,1000,1100,100,1,1,1
1099,Goesling,Reserve Black-on-white,4,1050,1200,150,1,1,1
1099,Goesling,Socorro Black-on-white,2,1050,1300,250,1,1,1
1099,Goesling,Tularosa Black-on-white,91,1180,1300,120,1,1,1
1099,Goesling,"White Mountain type, Type Undifferentiated; Early",69,1000,1300,300,0,0,1
1099,Goesling,Wingate Black-on-red,30,1050,1225,175,1,1,1
1099,Goesling,Wingate Polychrome,3,1100,1225,125,1,1,1
1103,Hubble Corner,"Cibola Corrugated Gray Ware, Undifferentiated",41,900,1400,500,0,0,0
1103,Hubble Corner,Fourmile Polychrome,1,1325,1400,75,1,1,1
1103,Hubble Corner,"Glaze Polychrome, Undifferentiated",1,1313,1700,387,0,1,1
1103,Hubble Corner,"Glaze-on-red, Undifferentiated",21,1313,1700,387,0,1,1
1103,Hubble Corner,Heshotauthla Polychrome,4,1275,1450,175,1,1,1
1103,Hubble Corner,Mogollon Plain Brown Ware,2,300,1400,1100,0,0,0
1103,Hubble Corner,Pinto Polychrome,1,1280,1330,50,1,1,1
1103,Hubble Corner,Puerco Black-on-white,7,1030,1200,170,1,1,1
1103,Hubble Corner,Red Mesa Black-on-white,4,880,1040,160,1,1,1
1103,Hubble Corner,"Red-on-brown, Undifferentiated",1,700,1450,750,0,1,1
1103,Hubble Corner,Reserve Black-on-white,154,1050,1200,150,1,1,1
1103,Hubble Corner,Socorro Black-on-white,7,1050,1300,250,1,1,1
1103,Hubble Corner,St. Johns Polychrome,404,1200,1300,100,1,1,1
1103,Hubble Corner,Tularosa Black-on-white,507,1180,1300,120,1,1,1
1103,Hubble Corner,Tularosa Fillet Rim,5,1100,1350,250,0,0,0
1103,Hubble Corner,"White ware, Undifferentiated",6,550,1900,1350,0,0,1
1103,Hubble Corner,Wingate Black-on-red,63,1050,1225,175,1,1,1
1103,Hubble Corner,Wingate Polychrome,7,1100,1225,125,1,1,1
1239,Bean Patch,Chaco Black-on-white,1,1075,1150,75,1,1,1
1239,Bean Patch,"Corrugated Gray Ware, Undifferentiated",9,800,1400,600,0,0,0
1239,Bean Patch,Fourmile Polychrome,2,1325,1400,75,1,1,1
1239,Bean Patch,Heshotauthla Polychrome,2,1275,1450,175,1,1,1
1239,Bean Patch,Hoyapi Black-on-white,1,1250,1300,50,1,1,1
1239,Bean Patch,Kana'a Gray Ware,1,865,1060,195,0,1,0
1239,Bean Patch,Lino Gray (Tusayan),2,550,950,400,0,0,0
1239,Bean Patch,"Mogollon Corrugated Brown Ware, Undifferentiated",2,800,1400,600,0,0,0
1239,Bean Patch,Pinedale Black-on-red,1,1280,1330,50,1,1,1
1239,Bean Patch,"Plain Gray Ware, Undifferentiated",1,500,1300,800,0,0,0
1239,Bean Patch,"Polychrome, Undifferentiated",1,700,1900,1200,0,1,1
1239,Bean Patch,Puerco Black-on-red,3,1000,1175,175,1,1,1
1239,Bean Patch,Red Mesa Black-on-white,4,880,1040,160,1,1,1
1239,Bean Patch,Reserve Black-on-white,5,1050,1200,150,1,1,1
1239,Bean Patch,St. Johns Black-on-red,1,1200,1300,100,1,1,1
1239,Bean Patch,St. Johns Polychrome,7,1200,1300,100,1,1,1
1239,Bean Patch,Tularosa Black-on-white,36,1180,1300,120,1,1,1
1239,Bean Patch,"Type, Undifferentiated",3,200,1900,1700,0,0,0
1239,Bean Patch,"White ware, Undifferentiated",6,550,1900,1350,0,0,1
1239,Bean Patch,Wingate Black-on-red,8,1050,1225,175,1,1,1
1239,Bean Patch,Wingate Polychrome,3,1100,1225,125,1,1,1
1240,Garcia Ranch,Alma Plain,3,300,1000,700,0,0,0
1240,Garcia Ranch,"Black-on-red, Undifferentiated",7,700,1700,1000,0,1,1
1240,Garcia Ranch,Chaco Black-on-white,2,1075,1150,75,1,1,1
1240,Garcia Ranch,Cibola Clapboard Corrugated Gray,3,900,1100,200,0,1,0
1240,Garcia Ranch,"Cibola Gray Ware, Undifferentiated",1,550,1400,850,0,0,0
1240,Garcia Ranch,Cibola Indented Corrugated Gray,45,1040,1400,360,0,0,0
1240,Garcia Ranch,Cibola Narrow Neckbanded,3,900,1025,125,0,1,0
1240,Garcia Ranch,"Cibola White Ware, Undifferentiated",11,550,1325,775,0,1,1
1240,Garcia Ranch,"Corrugated Gray Ware, Undifferentiated",50,800,1400,600,0,0,0
1240,Garcia Ranch,"Decorated Type, Undifferentiated",51,300,1900,1600,0,0,1
1240,Garcia Ranch,Escavada Black-on-white,6,1000,1100,100,1,1,1
1240,Garcia Ranch,Fourmile Polychrome,11,1325,1400,75,1,1,1
1240,Garcia Ranch,Gallup Black-on-white,6,1040,1150,110,1,1,1
1240,Garcia Ranch,"Glaze-on-yellow, Undifferentiated",5,1321,1700,379,0,1,1
1240,Garcia Ranch,Heshotauthla Black-on-red,3,1275,1450,175,1,1,1
1240,Garcia Ranch,Heshotauthla Polychrome,27,1275,1450,175,1,1,1
1240,Garcia Ranch,Kiatuthlanna Black-on-white,3,850,925,75,1,1,1
1240,Garcia Ranch,Kiet Siel Polychrome,1,1250,1320,70,1,1,1
1240,Garcia Ranch,Klagetoh Black-on-white,14,1250,1300,50,1,1,1
1240,Garcia Ranch,Kwakina Polychrome,18,1280,1450,170,1,1,1
1240,Garcia Ranch,Lino Gray (Cibola),4,550,950,400,1,0,0
1240,Garcia Ranch,"Mogollon Brown ware, Undifferentiated",4,900,1400,500,0,0,0
1240,Garcia Ranch,"Mogollon Corrugated Brown Ware, Undifferentiated",32,800,1400,600,0,0,0
1240,Garcia Ranch,Mogollon Indented Corrugated Brown Ware,37,1000,1400,400,0,0,0
1240,Garcia Ranch,"Mogollon Indented Corrugated Brown Ware, Smudged",8,1000,1400,400,0,0,0
1240,Garcia Ranch,Mogollon Patterned Corrugated Brown Ware,5,1000,1400,400,0,0,0
1240,Garcia Ranch,"Mogollon Patterned Corrugated Brown Ware, Smudged",2,1000,1400,400,0,0,0
1240,Garcia Ranch,"Mogollon Plain Brown Ware, Smudged",2,300,1400,1100,0,0,0
1240,Garcia Ranch,Mogollon Plain Corrugated Brown Ware,7,900,1400,500,0,0,0
1240,Garcia Ranch,"Mogollon Plain Corrugated Brown Ware, Smudged",5,900,1400,500,0,0,0
1240,Garcia Ranch,North Plains Black-on-red,1,1200,1300,100,1,1,1
1240,Garcia Ranch,Pinedale Black-on-red,31,1280,1330,50,1,1,1
1240,Garcia Ranch,Pinedale Black-on-white,82,1270,1320,50,1,1,1
1240,Garcia Ranch,Pinedale Polychrome,31,1290,1330,40,1,1,1
1240,Garcia Ranch,Pinto Polychrome,1,1280,1330,50,1,1,1
1240,Garcia Ranch,"Plain Gray Ware, Undifferentiated",30,500,1300,800,0,0,0
1240,Garcia Ranch,"Polychrome, Undifferentiated",3,700,1900,1200,0,1,1
1240,Garcia Ranch,Puerco Black-on-red,8,1000,1175,175,1,1,1
1240,Garcia Ranch,Puerco Black-on-white,8,1030,1200,170,1,1,1
1240,Garcia Ranch,"Puerco Valley Corrugated Gray Ware, Undifferentiated",102,800,1300,500,0,0,0
1240,Garcia Ranch,"Puerco Valley Gray Ware, Undifferentiated",9,400,1300,900,0,0,0
1240,Garcia Ranch,Red Mesa Black-on-white,14,880,1040,160,1,1,1
1240,Garcia Ranch,"Red Ware type, Undifferentiated",11,700,1700,1000,0,0,0
1240,Garcia Ranch,Reserve Black-on-white,21,1050,1200,150,1,1,1
1240,Garcia Ranch,Showlow Black-on-red,1,1030,1200,170,1,1,1
1240,Garcia Ranch,Snowflake Black-on-white,18,1100,1275,175,1,1,1
1240,Garcia Ranch,Springerville Polychrome,2,1250,1300,50,1,1,1
1240,Garcia Ranch,St. Johns Black-on-red,120,1200,1300,100,1,1,1
1240,Garcia Ranch,St. Johns Polychrome,179,1200,1300,100,1,1,1
1240,Garcia Ranch,Tularosa Black-on-white,386,1180,1300,120,1,1,1
1240,Garcia Ranch,"Tusayan Gray Ware, Undifferentiated",1,550,1285,735,0,0,0
1240,Garcia Ranch,"Type, Undifferentiated",3,200,1900,1700,0,0,0
1240,Garcia Ranch,"Undecorated Type, Undifferentiated",28,200,1900,1700,0,0,0
1240,Garcia Ranch,"White Mountain type, Type Undifferentiated; Early",33,1000,1300,300,0,0,1
1240,Garcia Ranch,"White Mountain type, Type Undifferentiated; Late",4,1280,1425,145,0,1,1
1240,Garcia Ranch,"White Mountain type, Undifferentiated; Zuni Glaze",3,1275,1450,175,0,1,1
1240,Garcia Ranch,"White ware, Undifferentiated",114,550,1900,1350,0,0,1
1240,Garcia Ranch,Wingate Black-on-red,81,1050,1225,175,1,1,1
1240,Garcia Ranch,Wingate Polychrome,60,1100,1225,125,1,1,1
1240,Garcia Ranch,Woodruff Brown,1,500,1100,600,0,0,0
1240,Garcia Ranch,Woodruff Red Smudged,1,400,1100,700,0,0,0
1244,Carter Ranch Pueblo,Alma Neck Banded,1,665,910,245,0,0,0
1244,Carter Ranch Pueblo,Alma Plain,434,300,1000,700,0,0,0
1244,Carter Ranch Pueblo,"Black-on-red, Undifferentiated",143,700,1700,1000,0,1,1
1244,Carter Ranch Pueblo,"Cibola Black-on-white, Undifferentiated",2047,550,1325,775,0,1,1
1244,Carter Ranch Pueblo,"Corrugated Gray Ware, Undifferentiated",60,800,1400,600,0,0,0
1244,Carter Ranch Pueblo,Gila Black-on-red,84,1300,1375,75,1,1,1
1244,Carter Ranch Pueblo,"Indented Corrugated Gray Ware, Undifferentiated",281,950,1400,450,0,0,0
1244,Carter Ranch Pueblo,Kana'a Gray Ware,1,865,1060,195,0,1,0
1244,Carter Ranch Pueblo,Kiatuthlanna Black-on-white,44,850,925,75,1,1,1
1244,Carter Ranch Pueblo,Lino Gray (Tusayan),23,550,950,400,0,0,0
1244,Carter Ranch Pueblo,McDonald Corrugated,1203,1150,1280,130,1,1,1
1244,Carter Ranch Pueblo,"Mogollon Corrugated Brown Ware, Undifferentiated",9737,800,1400,600,0,0,0
1244,Carter Ranch Pueblo,"Mogollon Corrugated, Red-slipped",28,1000,1400,400,0,0,0
1244,Carter Ranch Pueblo,"Mogollon Indented Corrugated Brown Ware, Smudged",1729,1000,1400,400,0,0,0
1244,Carter Ranch Pueblo,Mogollon Patterned Corrugated Brown Ware,1092,1000,1400,400,0,0,0
1244,Carter Ranch Pueblo,"Mogollon Patterned Corrugated Brown Ware, Smudged",66,1000,1400,400,0,0,0
1244,Carter Ranch Pueblo,"Mogollon Plain Corrugated Brown Ware, Smudged",398,900,1400,500,0,0,0
1244,Carter Ranch Pueblo,Pinedale Black-on-red,6,1280,1330,50,1,1,1
1244,Carter Ranch Pueblo,"Polychrome, Undifferentiated",12,700,1900,1200,0,1,1
1244,Carter Ranch Pueblo,Red Mesa Black-on-white,358,880,1040,160,1,1,1
1244,Carter Ranch Pueblo,"Red Ware type, Undifferentiated",72,700,1700,1000,0,0,0
1244,Carter Ranch Pueblo,Reserve Black-on-white,199,1050,1200,150,1,1,1
1244,Carter Ranch Pueblo,San Francisco Red,32,550,950,400,0,0,0
1244,Carter Ranch Pueblo,Showlow Black-on-red,1067,1030,1200,170,1,1,1
1244,Carter Ranch Pueblo,Snowflake Black-on-white,8366,1100,1275,175,1,1,1
1244,Carter Ranch Pueblo,Springerville Polychrome,30,1250,1300,50,1,1,1
1244,Carter Ranch Pueblo,St. Johns Black-on-red,146,1200,1300,100,1,1,1
1244,Carter Ranch Pueblo,St. Johns Polychrome,334,1200,1300,100,1,1,1
1244,Carter Ranch Pueblo,Tularosa Black-on-white,148,1180,1300,120,1,1,1
1244,Carter Ranch Pueblo,Tularosa Fillet Rim,1,1100,1350,250,0,0,0
1244,Carter Ranch Pueblo,"Type, Undifferentiated",268,200,1900,1700,0,0,0
1244,Carter Ranch Pueblo,"White Mountain type, Type Undifferentiated; Early",309,1000,1300,300,0,0,1
1244,Carter Ranch Pueblo,"White Mountain type, Type Undifferentiated; Late",2,1280,1425,145,0,1,1
1244,Carter Ranch Pueblo,"White ware, Undifferentiated",4735,550,1900,1350,0,0,1
1244,Carter Ranch Pueblo,"White-on-red, Undifferentiated",2,1065,1450,385,0,1,1
1244,Carter Ranch Pueblo,Wingate Black-on-red,298,1050,1225,175,1,1,1
1244,Carter Ranch Pueblo,Wingate Polychrome,26,1100,1225,125,1,1,1
1244,Carter Ranch Pueblo,Woodruff Smudged,213,500,1100,600,0,0,0
1256,Seven Springs,"Black-on-red, Undifferentiated",2,700,1700,1000,0,1,1
1256,Seven Springs,Chaco Black-on-white,2,1075,1150,75,1,1,1
1256,Seven Springs,"Cibola Corrugated Gray Ware, Undifferentiated",55,900,1400,500,0,0,0
1256,Seven Springs,Heshotauthla Polychrome,13,1275,1450,175,1,1,1
1256,Seven Springs,Holbrook A Black-on-white,3,1050,1150,100,1,1,1
1256,Seven Springs,Kana'a Gray Ware,2,865,1060,195,0,1,0
1256,Seven Springs,Kiatuthlanna Black-on-white,1,850,925,75,1,1,1
1256,Seven Springs,Lino Gray (Tusayan),2,550,950,400,0,0,0
1256,Seven Springs,"Mogollon Corrugated Brown Ware, Undifferentiated",8,800,1400,600,0,0,0
1256,Seven Springs,North Plains Black-on-red,4,1200,1300,100,1,1,1
1256,Seven Springs,Pinedale Polychrome,3,1290,1330,40,1,1,1
1256,Seven Springs,"Plain Gray Ware, Undifferentiated",59,500,1300,800,0,0,0
1256,Seven Springs,Puerco Black-on-red,14,1000,1175,175,1,1,1
1256,Seven Springs,Puerco Black-on-white,37,1030,1200,170,1,1,1
1256,Seven Springs,Red Mesa Black-on-white,5,880,1040,160,1,1,1
1256,Seven Springs,"Red Ware type, Undifferentiated",11,700,1700,1000,0,0,0
1256,Seven Springs,Reserve Black-on-white,8,1050,1200,150,1,1,1
1256,Seven Springs,Showlow Black-on-red,1,1030,1200,170,1,1,1
1256,Seven Springs,St. Johns Black-on-red,35,1200,1300,100,1,1,1
1256,Seven Springs,St. Johns Polychrome,36,1200,1300,100,1,1,1
1256,Seven Springs,Tularosa Black-on-white,163,1180,1300,120,1,1,1
1256,Seven Springs,"Type, Undifferentiated",4,200,1900,1700,0,0,0
1256,Seven Springs,"White ware, Undifferentiated",32,550,1900,1350,0,0,1
1256,Seven Springs,Wingate Black-on-red,35,1050,1225,175,1,1,1
1256,Seven Springs,Wingate Polychrome,15,1100,1225,125,1,1,1
1256,Seven Springs,Woodruff Smudged,1,500,1100,600,0,0,0
1288,Village of the Great Kivas,"Cibola Gray Ware, Undifferentiated",1,550,1400,850,0,0,0
1288,Village of the Great Kivas,Cibola Indented Corrugated Gray,42,1040,1400,360,0,0,0
1288,Village of the Great Kivas,"Cibola Late Corrugated Ware, Type Undifferentiated",1,1200,1400,200,0,1,0
1288,Village of the Great Kivas,Cibola Plain Gray,40,550,1040,490,0,0,0
1288,Village of the Great Kivas,"Cibola White Ware, Undifferentiated",14,550,1325,775,0,1,1
1288,Village of the Great Kivas,Dogoszhi Black-on-white,1,1040,1210,170,1,1,1
1288,Village of the Great Kivas,Escavada Black-on-white,21,1000,1100,100,1,1,1
1288,Village of the Great Kivas,Gallup Black-on-white,2,1040,1150,110,1,1,1
1288,Village of the Great Kivas,Holbrook B Black-on-white,5,1050,1150,100,1,1,1
1288,Village of the Great Kivas,Holbrook Black-on-white,1,1050,1150,100,1,1,1
1288,Village of the Great Kivas,Kana-a Black-on-white,1,825,1000,175,1,1,1
1288,Village of the Great Kivas,"Little Colorado White Ware, Undifferentiated",1,825,1250,425,0,1,1
1288,Village of the Great Kivas,Mesa Verde Black-on-white,2,1180,1280,100,1,1,1
1288,Village of the Great Kivas,"Mogollon Brown ware, Undifferentiated",4,900,1400,500,0,0,0
1288,Village of the Great Kivas,"Mogollon Indented Corrugated Brown Ware, Smudged",5,1000,1400,400,0,0,0
1288,Village of the Great Kivas,Padre Black-on-white,6,1100,1250,150,1,1,1
1288,Village of the Great Kivas,Puerco Black-on-red,33,1000,1175,175,1,1,1
1288,Village of the Great Kivas,Puerco Black-on-white,38,1030,1200,170,1,1,1
1288,Village of the Great Kivas,Puerco or Red Mesa Black-on-white,2,880,1200,320,0,0,1
1288,Village of the Great Kivas,Red Mesa Black-on-white,8,880,1040,160,1,1,1
1288,Village of the Great Kivas,Reserve Black-on-white,27,1050,1200,150,1,1,1
1288,Village of the Great Kivas,Reserve/Tularosa Black-on-white,7,1050,1300,250,1,1,1
1288,Village of the Great Kivas,Showlow Black-on-red,5,1030,1200,170,1,1,1
1288,Village of the Great Kivas,Showlow Polychrome,1,1300,1400,100,1,1,1
1288,Village of the Great Kivas,Showlow Red,2,1000,1100,100,0,1,0
1288,Village of the Great Kivas,Snowflake Black-on-white,1,1100,1275,175,1,1,1
1288,Village of the Great Kivas,St. Johns Polychrome,2,1200,1300,100,1,1,1
1288,Village of the Great Kivas,Tularosa Black-on-white,1,1180,1300,120,1,1,1
1288,Village of the Great Kivas,Tusayan B Polychrome,1,1110,1320,210,1,1,1
1288,Village of the Great Kivas,Tusayan Black-on-white,1,1200,1300,100,1,1,1
1288,Village of the Great Kivas,"White Mountain type, Type Undifferentiated; Early",3,1000,1300,300,0,0,1
1288,Village of the Great Kivas,Wingate Black-on-red,37,1050,1225,175,1,1,1
1288,Village of the Great Kivas,Wingate Polychrome,45,1100,1225,125,1,1,1
1288,Village of the Great Kivas,Woodruff Smudged,4,500,1100,600,0,0,0
1307,Fenced Up Horse Canyon,"Cibola Black-on-white, Undifferentiated",2,550,1325,775,0,1,1
1307,Fenced Up Horse Canyon,Cibola Indented Corrugated Gray,40,1040,1400,360,0,0,0
1307,Fenced Up Horse Canyon,Escavada-Puerco Black-on-white,1,1000,1100,100,1,1,1
1307,Fenced Up Horse Canyon,Reserve Black-on-white,5,1050,1200,150,1,1,1
1307,Fenced Up Horse Canyon,St. Johns Polychrome,4,1200,1300,100,1,1,1
1307,Fenced Up Horse Canyon,Tularosa Black-on-white,36,1180,1300,120,1,1,1
1307,Fenced Up Horse Canyon,"White Mountain type, Type Undifferentiated; Early",2,1000,1300,300,0,0,1
1307,Fenced Up Horse Canyon,Wingate Black-on-red,2,1050,1225,175,1,1,1
1307,Fenced Up Horse Canyon,Wingate Polychrome,21,1100,1225,125,1,1,1
1314,Los Gigantes,"Cibola Black-on-white, Undifferentiated",258,550,1325,775,0,1,1
1314,Los Gigantes,Cibola Clapboard Corrugated Gray,1,900,1100,200,0,1,0
1314,Los Gigantes,"Cibola Corrugated Gray Ware, Undifferentiated",2305,900,1400,500,0,0,0
1314,Los Gigantes,"Cibola Late Corrugated Ware, Type Undifferentiated",4,1200,1400,200,0,1,0
1314,Los Gigantes,Cibola Neckbanded Gray,17,850,1025,175,0,1,0
1314,Los Gigantes,Cibola Plain Gray,72,550,1040,490,0,0,0
1314,Los Gigantes,"Cibola White Ware, Undifferentiated",138,550,1325,775,0,1,1
1314,Los Gigantes,Gallup Black-on-white,1,1040,1150,110,1,1,1
1314,Los Gigantes,Heshotauthla Black-on-red or Polychrome,1,1275,1450,175,1,1,1
1314,Los Gigantes,Kwakina Polychrome,5,1280,1450,170,1,1,1
1314,Los Gigantes,"Mogollon Corrugated Brown Ware, Undifferentiated",1,800,1400,600,0,0,0
1314,Los Gigantes,"Mogollon Corrugated Smudged Brown Ware, Undifferentiated",6,1000,1450,450,0,0,0
1314,Los Gigantes,Mogollon Plain Brown Ware,6,300,1400,1100,0,0,0
1314,Los Gigantes,Pinedale Black-on-red,2,1280,1330,50,1,1,1
1314,Los Gigantes,Pinedale Black-on-white,17,1270,1320,50,1,1,1
1314,Los Gigantes,Puerco Black-on-white,3,1030,1200,170,1,1,1
1314,Los Gigantes,Red Mesa Black-on-white,2,880,1040,160,1,1,1
1314,Los Gigantes,Reserve Black-on-white,6,1050,1200,150,1,1,1
1314,Los Gigantes,Socorro Black-on-white,1,1050,1300,250,1,1,1
1314,Los Gigantes,Springerville Polychrome,4,1250,1300,50,1,1,1
1314,Los Gigantes,St. Johns Black-on-red,153,1200,1300,100,1,1,1
1314,Los Gigantes,St. Johns Polychrome,333,1200,1300,100,1,1,1
1314,Los Gigantes,Tularosa Black-on-white,100,1180,1300,120,1,1,1
1314,Los Gigantes,"Type, Undifferentiated",31,200,1900,1700,0,0,0
1314,Los Gigantes,"White Mountain type, Type Undifferentiated; Early",687,1000,1300,300,0,0,1
1314,Los Gigantes,"White ware, Undifferentiated",6,550,1900,1350,0,0,1
1314,Los Gigantes,Wingate Black-on-red,4,1050,1225,175,1,1,1
1314,Los Gigantes,Wingate Polychrome,2,1100,1225,125,1,1,1
1316,Spier 81,"Cibola Black-on-white, Undifferentiated",45,550,1325,775,0,1,1
1316,Spier 81,"Cibola Corrugated Gray Ware, Undifferentiated",98,900,1400,500,0,0,0
1316,Spier 81,Cibola Indented Corrugated Gray,152,1040,1400,360,0,0,0
1316,Spier 81,Cibola Plain Corrugated Gray,5,900,1100,200,0,1,0
1316,Spier 81,Cibola Plain Gray,22,550,1040,490,0,0,0
1316,Spier 81,"Cibola White Ware, Undifferentiated",26,550,1325,775,0,1,1
1316,Spier 81,Escavada Black-on-white,2,1000,1100,100,1,1,1
1316,Spier 81,Gallup Black-on-white,1,1040,1150,110,1,1,1
1316,Spier 81,Puerco Black-on-red,3,1000,1175,175,1,1,1
1316,Spier 81,Puerco Black-on-white,6,1030,1200,170,1,1,1
1316,Spier 81,Red Mesa Black-on-white,1,880,1040,160,1,1,1
1316,Spier 81,Reserve Black-on-white,3,1050,1200,150,1,1,1
1316,Spier 81,St. Johns Black-on-red,24,1200,1300,100,1,1,1
1316,Spier 81,St. Johns Black-on-red or Polychrome,3,1200,1300,100,1,1,1
1316,Spier 81,St. Johns Polychrome,33,1200,1300,100,1,1,1
1316,Spier 81,Tularosa Black-on-white,39,1180,1300,120,1,1,1
1316,Spier 81,"Type, Undifferentiated",26,200,1900,1700,0,0,0
1316,Spier 81,"White Mountain type, Type Undifferentiated; Early",122,1000,1300,300,0,0,1
1316,Spier 81,Wingate Black-on-red,19,1050,1225,175,1,1,1
1316,Spier 81,Wingate Polychrome,12,1100,1225,125,1,1,1
1365,Wupatki,Angell Brown,16,1000,1150,150,0,1,0
1365,Wupatki,Black Mesa Black-on-white,22,1000,1100,100,1,1,1
1365,Wupatki,"Black-on-red, Undifferentiated",4,700,1700,1000,0,1,1
1365,Wupatki,Chevelon Black-on-white,7,1070,1125,55,1,1,1
1365,Wupatki,Citadel Polychrome,1032,1040,1200,160,1,1,1
1365,Wupatki,Deadmans Black-on-gray,2,900,1100,200,1,1,1
1365,Wupatki,Deadmans Fugitive Red,236,900,1100,200,0,1,0
1365,Wupatki,Deadmans Gray,143,775,1200,425,0,0,0
1365,Wupatki,Dogoszhi Black-on-white,253,1040,1210,170,1,1,1
1365,Wupatki,Elden Corrugated type,371,1085,1200,115,0,1,0
1365,Wupatki,Flagstaff Black-on-white,5436,1150,1220,70,1,1,1
1365,Wupatki,Holbrook Black-on-white,39,1050,1150,100,1,1,1
1365,Wupatki,Jeddito Black-on-yellow,59,1300,1450,150,1,1,1
1365,Wupatki,Kayenta Black-on-white,37,1250,1300,50,1,1,1
1365,Wupatki,Kia-ko Black-on-white,34,1100,1150,50,1,1,1
1365,Wupatki,Kiet Siel Polychrome,14,1250,1320,70,1,1,1
1365,Wupatki,"Little Colorado Corrugated Gray Ware, Undifferentiated",84,1050,1250,200,0,1,0
1365,Wupatki,"Little Colorado White Ware, Undifferentiated",73,825,1250,425,0,1,1
1365,Wupatki,McDonald Corrugated,1,1150,1280,130,1,1,1
1365,Wupatki,Medicine Black-on-red,5,1040,1170,130,1,1,1
1365,Wupatki,Medicine Gray,77,950,1100,150,0,1,0
1365,Wupatki,Moenkopi Corrugated,4627,1130,1250,120,0,1,0
1365,Wupatki,"Mogollon Brown ware, Undifferentiated",10,900,1400,500,0,0,0
1365,Wupatki,"Mogollon Corrugated Brown Ware, Undifferentiated",210,800,1400,600,0,0,0
1365,Wupatki,Padre Black-on-white,72,1100,1250,150,1,1,1
1365,Wupatki,Polacca Black-on-white,2,1150,1250,100,1,1,1
1365,Wupatki,"Red Ware type, Undifferentiated",4,700,1700,1000,0,0,0
1365,Wupatki,"San Juan Red ware, Undifferentiated",107,700,1050,350,0,0,1
1365,Wupatki,Shato Black-on-white,34,1025,1150,125,1,1,1
1365,Wupatki,Showlow Black-on-red,106,1030,1200,170,1,1,1
1365,Wupatki,Sosi Black-on-white,447,1070,1180,110,1,1,1
1365,Wupatki,St. Johns Polychrome,14,1200,1300,100,1,1,1
1365,Wupatki,Sunset Red/Sunset Brown,15871,1065,1200,135,0,1,0
1365,Wupatki,Tsegi Polychrome,15,1225,1300,75,1,1,1
1365,Wupatki,Tsegi Red-on-orange,13,1200,1300,100,1,1,1
1365,Wupatki,Turkey Hill Red,815,1120,1200,80,0,1,0
1365,Wupatki,Tusayan Black-on-red,810,1045,1240,195,1,1,1
1365,Wupatki,Tusayan Black-on-white,2,1200,1300,100,1,1,1
1365,Wupatki,Tusayan Corrugated,3287,1020,1275,255,0,0,0
1365,Wupatki,"Tusayan Gray Ware, Undifferentiated",163,550,1285,735,0,0,0
1365,Wupatki,Tusayan Polychrome,127,1110,1320,210,1,1,1
1365,Wupatki,"Tusayan White Ware, Undifferentiated",1747,825,1300,475,0,1,1
1365,Wupatki,Verde Gray,256,1100,1300,200,0,1,0
1365,Wupatki,Walnut Black-on-white,2277,1100,1250,150,1,1,1
1365,Wupatki,Winona Brown,3712,1075,1200,125,0,1,0
1365,Wupatki,Winona Corrugated,9,1080,1120,40,0,1,0
1365,Wupatki,Wupatki Black-on-white,1495,1125,1300,175,1,1,1
1365,Wupatki,Youngs Brown,195,1070,1151,81,0,1,0
1368,Lukachukai GH,Black Mesa Black-on-white,3,1000,1100,100,1,1,1
1368,Lukachukai GH,"Chuska Gray Ware, Type Undifferentiated",1,700,1300,600,0,0,0
1368,Lukachukai GH,"Cibola Black-on-white, Undifferentiated",1,550,1325,775,0,1,1
1368,Lukachukai GH,"Corrugated Gray Ware, Undifferentiated",2,800,1400,600,0,0,0
1368,Lukachukai GH,Dogoszhi Black-on-white,5,1040,1210,170,1,1,1
1368,Lukachukai GH,Escavada Black-on-white,1,1000,1100,100,1,1,1
1368,Lukachukai GH,Flagstaff Black-on-white,2,1150,1220,70,1,1,1
1368,Lukachukai GH,Gallup Black-on-white,1,1040,1150,110,1,1,1
1368,Lukachukai GH,Kana-a Black-on-white,30,825,1000,175,1,1,1
1368,Lukachukai GH,Kana'a Neckbanded,4,865,1060,195,0,1,0
1368,Lukachukai GH,Kayenta Black-on-white,1,1250,1300,50,1,1,1
1368,Lukachukai GH,Moenkopi Corrugated,1,1130,1250,120,0,1,0
1368,Lukachukai GH,"San Juan Red ware, Undifferentiated",8,700,1050,350,0,0,1
1368,Lukachukai GH,Showlow Black-on-red,3,1030,1200,170,1,1,1
1368,Lukachukai GH,Sosi Black-on-white,13,1070,1180,110,1,1,1
1368,Lukachukai GH,Tsegi Black-on-orange,1,1225,1300,75,1,1,1
1368,Lukachukai GH,"Tsegi Orange Ware, Undifferentiated",9,1000,1300,300,1,0,1
1368,Lukachukai GH,Tusayan Black-on-red,19,1045,1240,195,1,1,1
1368,Lukachukai GH,Tusayan Corrugated,23,1020,1275,255,0,0,0
1368,Lukachukai GH,Tusayan Polychrome,13,1110,1320,210,1,1,1
1368,Lukachukai GH,"Tusayan White Ware, Undifferentiated",13,825,1300,475,0,1,1
1368,Lukachukai GH,White Mound Black-on-white,1,700,850,150,1,1,1
1368,Lukachukai GH,"White Mountain type, Type Undifferentiated; Early",1,1000,1300,300,0,0,1
1368,Lukachukai GH,Wingate Black-on-red,1,1050,1225,175,1,1,1
1368,Lukachukai GH,Wingate Polychrome,19,1100,1225,125,1,1,1
1373,Antelope House,Black Mesa Black-on-white,229,1000,1100,100,1,1,1
1373,Antelope House,Cameron Polychrome,1,1040,1170,130,1,1,1
1373,Antelope House,Chaco Black-on-white,49,1075,1150,75,1,1,1
1373,Antelope House,Citadel Polychrome,3,1040,1200,160,1,1,1
1373,Antelope House,Cortez Black-on-white,2,880,1060,180,1,1,1
1373,Antelope House,Deadmans (La Plata) Black-on-red,1,880,1050,170,1,1,1
1373,Antelope House,Dogoszhi Black-on-white,79,1040,1210,170,1,1,1
1373,Antelope House,Escavada Black-on-white,1,1000,1100,100,1,1,1
1373,Antelope House,Flagstaff Black-on-white,42,1150,1220,70,1,1,1
1373,Antelope House,Gallup Black-on-white,14,1040,1150,110,1,1,1
1373,Antelope House,Holbrook Black-on-white,7,1050,1150,100,1,1,1
1373,Antelope House,Kana-a Black-on-white,420,825,1000,175,1,1,1
1373,Antelope House,Kayenta Black-on-white,3,1250,1300,50,1,1,1
1373,Antelope House,Kiatuthlanna Black-on-white,6,850,925,75,1,1,1
1373,Antelope House,Kiet Siel Polychrome,1,1250,1320,70,1,1,1
1373,Antelope House,Leupp Black-on-white,4,1200,1250,50,1,1,1
1373,Antelope House,Mancos Black-on-white,14,980,1180,200,1,1,1
1373,Antelope House,McElmo Black-on-white,60,1060,1260,200,1,1,1
1373,Antelope House,Medicine Black-on-red,32,1040,1170,130,1,1,1
1373,Antelope House,Mesa Verde Black-on-white,113,1180,1280,100,1,1,1
1373,Antelope House,Padre Black-on-white,6,1100,1250,150,1,1,1
1373,Antelope House,Pinedale Black-on-red,2,1280,1330,50,1,1,1
1373,Antelope House,Puerco Black-on-white,23,1030,1200,170,1,1,1
1373,Antelope House,Red Mesa Black-on-white,143,880,1040,160,1,1,1
1373,Antelope House,Reserve Black-on-white,1,1050,1200,150,1,1,1
1373,Antelope House,Sosi Black-on-white,89,1070,1180,110,1,1,1
1373,Antelope House,St. Johns Black-on-red or Polychrome,108,1200,1300,100,1,1,1
1373,Antelope House,Tsegi Orange,2,1250,1300,50,1,1,1
1373,Antelope House,Tularosa Black-on-white,1,1180,1300,120,1,1,1
1373,Antelope House,Tusayan Black-on-red,49,1045,1240,195,1,1,1
1373,Antelope House,Tusayan Polychrome,93,1110,1320,210,1,1,1
1373,Antelope House,"Undecorated Type, Undifferentiated",486,200,1900,1700,0,0,0
1373,Antelope House,Walnut Black-on-white,29,1100,1250,150,1,1,1
1373,Antelope House,White Mound Black-on-white,1,700,850,150,1,1,1
1373,Antelope House,"White ware, Undifferentiated",156,550,1900,1350,0,0,1
1373,Antelope House,Wingate Black-on-red,21,1050,1225,175,1,1,1
1376,White House,Abajo Red-on-orange,6,760,880,120,1,1,1
1376,White House,Black Mesa Black-on-white,152,1000,1100,100,1,1,1
1376,White House,Bluff Black-on-red,20,800,925,125,1,1,1
1376,White House,Brimhall Black-on-white,12,1040,1150,110,1,1,1
1376,White House,Burnham Black-on-white,4,860,1000,140,1,1,1
1376,White House,Chaco Black-on-white,20,1075,1150,75,1,1,1
1376,White House,Chaco-McElmo Black-on-white (carbon paint),2,1090,1175,85,1,1,1
1376,White House,Chuska Black-on-white,8,1040,1125,85,1,1,1
1376,White House,Chuska Indented Corrugated Gray,6,1040,1300,260,0,0,0
1376,White House,"Cibola Corrugated Gray Ware, Undifferentiated",2,900,1400,500,0,0,0
1376,White House,Cibola Indented Corrugated Gray,12,1040,1400,360,0,0,0
1376,White House,Cibola Plain Gray,8,550,1040,490,0,0,0
1376,White House,"Cibola White Ware, Undifferentiated",36,550,1325,775,0,1,1
1376,White House,Coconino Gray,10,950,1100,150,0,1,0
1376,White House,"Corrugated Gray Ware, Undifferentiated",98,800,1400,600,0,0,0
1376,White House,Cortez Black-on-white,36,880,1060,180,1,1,1
1376,White House,Deadmans (La Plata) Black-on-red,12,880,1050,170,1,1,1
1376,White House,Dogoszhi Black-on-white,10,1040,1210,170,1,1,1
1376,White House,Dolores Corrugated,2,1100,1200,100,0,1,0
1376,White House,Escavada Black-on-white,14,1000,1100,100,1,1,1
1376,White House,Flagstaff Black-on-white,26,1150,1220,70,1,1,1
1376,White House,Gallup Black-on-white,44,1040,1150,110,1,1,1
1376,White House,Holbrook B Black-on-white,2,1050,1150,100,1,1,1
1376,White House,Holbrook Black-on-white,2,1050,1150,100,1,1,1
1376,White House,"Indented Corrugated Gray Ware, Undifferentiated",18,950,1400,450,0,0,0
1376,White House,Kana-a Black-on-white,166,825,1000,175,1,1,1
1376,White House,Kana'a Gray Ware,4,865,1060,195,0,1,0
1376,White House,Kayenta Black-on-white,2,1250,1300,50,1,1,1
1376,White House,Kiatuthlanna Black-on-white,18,850,925,75,1,1,1
1376,White House,Kiet Siel Polychrome,4,1250,1320,70,1,1,1
1376,White House,Kintiel Black-on-orange,6,1275,1300,25,1,1,1
1376,White House,Klagetoh Black-on-white,14,1250,1300,50,1,1,1
1376,White House,Klagetoh Polychrome,4,1250,1325,75,1,1,1
1376,White House,Lino Black-on-gray (Cibola),4,600,850,250,1,1,1
1376,White House,Lino Black-on-gray (Tusayan),8,600,850,250,1,1,1
1376,White House,Lino Gray (Tusayan),50,550,950,400,0,0,0
1376,White House,Lino Gray Fugitive Red [Tusayan Series],2,600,950,350,0,0,0
1376,White House,"Little Colorado White Ware, Undifferentiated",8,825,1250,425,0,1,1
1376,White House,Mancos Black-on-white,6,980,1180,200,1,1,1
1376,White House,Mancos Corrugated,2,920,1180,260,0,0,0
1376,White House,McElmo Black-on-white,42,1060,1260,200,1,1,1
1376,White House,Medicine Black-on-red,2,1040,1170,130,1,1,1
1376,White House,Mesa Verde Black-on-white,40,1180,1280,100,1,1,1
1376,White House,"Mesa Verde Corrugated Gray Ware, Undifferentiated",16,920,1280,360,0,0,0
1376,White House,"Mesa Verde Gray ware, Undifferentiated",2,575,1280,705,0,0,0
1376,White House,"Mesa Verde White Ware, Undifferentiated",38,575,1280,705,0,1,1
1376,White House,Moenkopi Corrugated,8,1130,1250,120,0,1,0
1376,White House,"Neckbanded Gray Ware, Undifferentiated",2,850,1025,175,0,1,0
1376,White House,Newcomb Black-on-white,4,875,1000,125,1,1,1
1376,White House,Obelisk Gray,24,400,700,300,0,0,0
1376,White House,Padre Black-on-white,10,1100,1250,150,1,1,1
1376,White House,Pinedale Polychrome,2,1290,1330,40,1,1,1
1376,White House,"Plain Brown Ware, Undifferentiated",4,400,1450,1050,0,0,0
1376,White House,"Plain Gray Ware, Undifferentiated",250,500,1300,800,0,0,0
1376,White House,Puerco Black-on-white,4,1030,1200,170,1,1,1
1376,White House,Red Mesa Black-on-white,76,880,1040,160,1,1,1
1376,White House,"Red Ware type, Undifferentiated",6,700,1700,1000,0,0,0
1376,White House,Reserve Black-on-white,4,1050,1200,150,1,1,1
1376,White House,"San Juan Red ware, Undifferentiated",8,700,1050,350,0,0,1
1376,White House,Showlow Black-on-red,2,1030,1200,170,1,1,1
1376,White House,Showlow Red,2,1000,1100,100,0,1,0
1376,White House,Snowflake Black-on-white,2,1100,1275,175,1,1,1
1376,White House,Sosi Black-on-white,54,1070,1180,110,1,1,1
1376,White House,St. Johns Black-on-red,28,1200,1300,100,1,1,1
1376,White House,St. Johns Polychrome,30,1200,1300,100,1,1,1
1376,White House,Tallohogan Red,4,620,875,255,0,0,0
1376,White House,Taylor Black-on-white,2,1000,1100,100,1,1,1
1376,White House,Toadlena Black-on-white,8,975,1125,150,1,1,1
1376,White House,Tsegi Black-on-orange,2,1225,1300,75,1,1,1
1376,White House,"Tsegi Orange Ware, Undifferentiated",12,1000,1300,300,1,0,1
1376,White House,Tularosa Black-on-white,2,1180,1300,120,1,1,1
1376,White House,Tunicha Black-on-white,8,850,900,50,1,1,1
1376,White House,Tusayan A Polychrome,12,1110,1320,210,1,1,1
1376,White House,Tusayan B Polychrome,12,1110,1320,210,1,1,1
1376,White House,Tusayan Black-on-red,14,1045,1240,195,1,1,1
1376,White House,Tusayan Black-on-white,28,1200,1300,100,1,1,1
1376,White House,Tusayan Corrugated,38,1020,1275,255,0,0,0
1376,White House,"Tusayan Gray Ware, Undifferentiated",94,550,1285,735,0,0,0
1376,White House,Tusayan Polychrome,2,1110,1320,210,1,1,1
1376,White House,"Tusayan White Ware, Undifferentiated",58,825,1300,475,0,1,1
1376,White House,Walnut A Black-on-white,4,1100,1250,150,1,1,1
1376,White House,Walnut B Black-on-white,10,1200,1250,50,1,1,1
1376,White House,Wepo Black-on-white,4,930,1050,120,1,1,1
1376,White House,White Mound Black-on-white,4,700,850,150,1,1,1
1376,White House,"White Mountain type, Type Undifferentiated; Early",34,1000,1300,300,0,0,1
1376,White House,"White ware, Undifferentiated",30,550,1900,1350,0,0,1
1376,White House,Wingate Black-on-red,22,1050,1225,175,1,1,1
1376,White House,Wingate Polychrome,38,1100,1225,125,1,1,1
1376,White House,Woodruff Brown,2,500,1100,600,0,0,0
1377,Salina Springs,Bidahochi Black-on-white,4,1325,1400,75,1,1,1
1377,Salina Springs,Black Mesa Black-on-white,4,1000,1100,100,1,1,1
1377,Salina Springs,Chaco Black-on-white,2,1075,1150,75,1,1,1
1377,Salina Springs,Dogoszhi Black-on-white,6,1040,1210,170,1,1,1
1377,Salina Springs,Flagstaff Black-on-white,14,1150,1220,70,1,1,1
1377,Salina Springs,Holbrook A Black-on-white,1,1050,1150,100,1,1,1
1377,Salina Springs,Holbrook B Black-on-white,1,1050,1150,100,1,1,1
1377,Salina Springs,Kana-a Black-on-white,2,825,1000,175,1,1,1
1377,Salina Springs,Kana'a Neckbanded,4,865,1060,195,0,1,0
1377,Salina Springs,Kayenta Black-on-white,6,1250,1300,50,1,1,1
1377,Salina Springs,Kayenta Polychrome,4,1250,1320,70,1,1,1
1377,Salina Springs,"Kintiel-Klagetoh, Type Undifferentiated",2,1250,1325,75,1,1,1
1377,Salina Springs,Klagetoh Black-on-white,2,1250,1300,50,1,1,1
1377,Salina Springs,Klagetoh Black-on-yellow,6,1250,1300,50,1,1,1
1377,Salina Springs,Leupp Black-on-white,4,1200,1250,50,1,1,1
1377,Salina Springs,Lino Black-on-gray (Tusayan),2,600,850,250,1,1,1
1377,Salina Springs,Moenkopi Corrugated,4,1130,1250,120,0,1,0
1377,Salina Springs,Padre Black-on-white,2,1100,1250,150,1,1,1
1377,Salina Springs,"Plain Gray Ware, Undifferentiated",4,500,1300,800,0,0,0
1377,Salina Springs,Puerco Black-on-white,6,1030,1200,170,1,1,1
1377,Salina Springs,Shato Black-on-white,2,1025,1150,125,1,1,1
1377,Salina Springs,Sosi Black-on-white,8,1070,1180,110,1,1,1
1377,Salina Springs,St. Johns Polychrome,2,1200,1300,100,1,1,1
1377,Salina Springs,Tusayan Black-on-red,8,1045,1240,195,1,1,1
1377,Salina Springs,Tusayan Black-on-white,7,1200,1300,100,1,1,1
1377,Salina Springs,Tusayan Corrugated,16,1020,1275,255,0,0,0
1377,Salina Springs,Tusayan Polychrome,14,1110,1320,210,1,1,1
1377,Salina Springs,White Mound Black-on-white,2,700,850,150,1,1,1
1377,Salina Springs,Wingate Polychrome,1,1100,1225,125,1,1,1
1394,Ridge Ruin,Angell Brown,5240,1000,1150,150,0,1,0
1394,Ridge Ruin,Black Mesa Black-on-white,2570,1000,1100,100,1,1,1
1394,Ridge Ruin,"Buff Ware, Undifferentiated",1,300,1450,1150,0,1,0
1394,Ridge Ruin,Chevelon Black-on-white,17,1070,1125,55,1,1,1
1394,Ridge Ruin,"Cibola Corrugated Gray Ware, Undifferentiated",48,900,1400,500,0,0,0
1394,Ridge Ruin,Citadel Polychrome,261,1040,1200,160,1,1,1
1394,Ridge Ruin,Coconino Red-on-buff,36,1050,1150,100,1,1,1
1394,Ridge Ruin,Deadmans Black-on-gray,26,900,1100,200,1,1,1
1394,Ridge Ruin,Deadmans Fugitive Red,1705,900,1100,200,0,1,0
1394,Ridge Ruin,Deadmans Gray,249,775,1200,425,0,0,0
1394,Ridge Ruin,Dogoszhi Black-on-white,221,1040,1210,170,1,1,1
1394,Ridge Ruin,Flagstaff Black-on-white,1303,1150,1220,70,1,1,1
1394,Ridge Ruin,Flagstaff Corrugated,140,1000,1400,400,0,0,0
1394,Ridge Ruin,Holbrook B Black-on-white,390,1050,1150,100,1,1,1
1394,Ridge Ruin,Holbrook Black-on-white,837,1050,1150,100,1,1,1
1394,Ridge Ruin,Leupp Black-on-white,183,1200,1250,50,1,1,1
1394,Ridge Ruin,"Little Colorado Corrugated Gray Ware, Undifferentiated",34,1050,1250,200,0,1,0
1394,Ridge Ruin,"Little Colorado White Ware, Undifferentiated",160,825,1250,425,0,1,1
1394,Ridge Ruin,Medicine Black-on-red,5,1040,1170,130,1,1,1
1394,Ridge Ruin,Moenkopi Corrugated,111,1130,1250,120,0,1,0
1394,Ridge Ruin,"Plain Gray Ware, Undifferentiated",258,500,1300,800,0,0,0
1394,Ridge Ruin,"Red Ware type, Undifferentiated",46,700,1700,1000,0,0,0
1394,Ridge Ruin,Rio de Flag Brown,152,775,1065,290,0,0,0
1394,Ridge Ruin,San Francisco Red,25,550,950,400,0,0,0
1394,Ridge Ruin,Shato Black-on-white,101,1025,1150,125,1,1,1
1394,Ridge Ruin,Sosi Black-on-white,21,1070,1180,110,1,1,1
1394,Ridge Ruin,Sunset Red/Sunset Brown,36326,1065,1200,135,0,1,0
1394,Ridge Ruin,Turkey Hill Red,256,1120,1200,80,0,1,0
1394,Ridge Ruin,Tusayan Black-on-red,1184,1045,1240,195,1,1,1
1394,Ridge Ruin,Tusayan Black-on-white,37,1200,1300,100,1,1,1
1394,Ridge Ruin,Tusayan Corrugated,4707,1020,1275,255,0,0,0
1394,Ridge Ruin,"Tusayan White Ware, Undifferentiated",668,825,1300,475,0,1,1
1394,Ridge Ruin,"Type, Undifferentiated",194,200,1900,1700,0,0,0
1394,Ridge Ruin,"Undecorated Type, Undifferentiated",5,200,1900,1700,0,0,0
1394,Ridge Ruin,Walnut A Black-on-white,218,1100,1250,150,1,1,1
1394,Ridge Ruin,Walnut B Black-on-white,500,1200,1250,50,1,1,1
1394,Ridge Ruin,Walnut Black-on-white,251,1100,1250,150,1,1,1
1394,Ridge Ruin,Wingfield Plain,9,1100,1300,200,0,1,0
1394,Ridge Ruin,Winona Brown,20609,1075,1200,125,0,1,0
1394,Ridge Ruin,Winona Corrugated,319,1080,1120,40,0,1,0
1394,Ridge Ruin,Winona Red-on-buff,29,1050,1150,100,1,1,1
1394,Ridge Ruin,Youngs Brown,7692,1070,1151,81,0,1,0
1531,Burnt Corn GH,Black Mesa Black-on-white,20,1000,1100,100,1,1,1
1531,Burnt Corn GH,Citadel Polychrome,1,1040,1200,160,1,1,1
1531,Burnt Corn GH,"Corrugated Gray Ware, Undifferentiated",277,800,1400,600,0,0,0
1531,Burnt Corn GH,Hoyapi Black-on-white,9,1250,1300,50,1,1,1
1531,Burnt Corn GH,Jeddito Black-on-orange,1,1250,1300,50,1,1,1
1531,Burnt Corn GH,Kiet Siel Polychrome,1,1250,1320,70,1,1,1
1531,Burnt Corn GH,"Plain Gray Ware, Undifferentiated",56,500,1300,800,0,0,0
1531,Burnt Corn GH,Polacca Black-on-white,17,1150,1250,100,1,1,1
1531,Burnt Corn GH,Sosi Black-on-white,28,1070,1180,110,1,1,1
1531,Burnt Corn GH,"Tsegi Orange Ware, Undifferentiated",16,1000,1300,300,1,0,1
1531,Burnt Corn GH,Tusayan B Polychrome,2,1110,1320,210,1,1,1
1531,Burnt Corn GH,Tusayan Black-on-red,1,1045,1240,195,1,1,1
1531,Burnt Corn GH,Tusayan Black-on-white,5,1200,1300,100,1,1,1
1531,Burnt Corn GH,"Type, Undifferentiated",2,200,1900,1700,0,0,0
1531,Burnt Corn GH,"White ware, Undifferentiated",117,550,1900,1350,0,0,1
1618,Castle Rock Pueblo,Abajo Red-on-orange,2,760,880,120,1,1,1
1618,Castle Rock Pueblo,Chapin Black-on-white,1,575,880,305,0,1,1
1618,Castle Rock Pueblo,Chapin Gray,2,575,980,405,0,0,0
1618,Castle Rock Pueblo,Deadmans (La Plata) Black-on-red,4,880,1050,170,1,1,1
1618,Castle Rock Pueblo,Mancos Black-on-white,6,980,1180,200,1,1,1
1618,Castle Rock Pueblo,Mancos Corrugated,38,920,1180,260,0,0,0
1618,Castle Rock Pueblo,Mancos Gray,2,880,1060,180,0,1,0
1618,Castle Rock Pueblo,McElmo Black-on-white,109,1060,1260,200,1,1,1
1618,Castle Rock Pueblo,Mesa Verde Black-on-white,736,1180,1280,100,1,1,1
1618,Castle Rock Pueblo,"Mesa Verde BMIII/PI White Ware, Type Undifferentiated",3,575,920,345,0,1,1
1618,Castle Rock Pueblo,Mesa Verde Corrugated,338,1100,1280,180,0,1,0
1618,Castle Rock Pueblo,"Mesa Verde Corrugated Gray Ware, Undifferentiated",27599,920,1280,360,0,0,0
1618,Castle Rock Pueblo,"Mesa Verde PII White Ware, Type Undifferentiated",4,920,1100,180,1,1,1
1618,Castle Rock Pueblo,"Mesa Verde PII/PIII White Ware, Type Undifferentiated",8225,920,1280,360,0,1,1
1618,Castle Rock Pueblo,"Mesa Verde PIII White Ware, Type Undifferentiated",4760,1100,1280,180,1,1,1
1618,Castle Rock Pueblo,"Mesa Verde White Ware, Undifferentiated",23,575,1280,705,0,1,1
1618,Castle Rock Pueblo,Moccasin Gray,4,800,980,180,0,1,0
1618,Castle Rock Pueblo,"Plain Gray Ware, Undifferentiated",19,500,1300,800,0,0,0
1618,Castle Rock Pueblo,"Polychrome, Undifferentiated",1,700,1900,1200,0,1,1
1618,Castle Rock Pueblo,"Red Ware type, Undifferentiated",1,700,1700,1000,0,0,0
1618,Castle Rock Pueblo,"San Juan Red ware, Undifferentiated",13,700,1050,350,0,0,1
1618,Castle Rock Pueblo,"Type, Undifferentiated",37,200,1900,1700,0,0,0
1618,Castle Rock Pueblo,"White ware, Undifferentiated",18,550,1900,1350,0,0,1
1935,Morris 41,Abajo Red-on-orange,1,760,880,120,1,1,1
1935,Morris 41,Bluff Black-on-red,7,800,925,125,1,1,1
1935,Morris 41,Chaco-McElmo Black-on-white (carbon paint),10,1090,1175,85,1,1,1
1935,Morris 41,Chapin Gray,10,575,980,405,0,0,0
1935,Morris 41,Chuska Black-on-white,1,1040,1125,85,1,1,1
1935,Morris 41,Citadel Polychrome,2,1040,1200,160,1,1,1
1935,Morris 41,"Corrugated Gray Ware, Undifferentiated",40,800,1400,600,0,0,0
1935,Morris 41,Cortez Black-on-white,35,880,1060,180,1,1,1
1935,Morris 41,Deadmans (La Plata) Black-on-red,1,880,1050,170,1,1,1
1935,Morris 41,Dolores Corrugated,2,1100,1200,100,0,1,0
1935,Morris 41,Escavada Black-on-white,8,1000,1100,100,1,1,1
1935,Morris 41,Gallup Black-on-white,13,1040,1150,110,1,1,1
1935,Morris 41,Mancos Black-on-white,150,980,1180,200,1,1,1
1935,Morris 41,Mancos Corrugated,7,920,1180,260,0,0,0
1935,Morris 41,Mancos Gray,2,880,1060,180,0,1,0
1935,Morris 41,McElmo Black-on-white,289,1060,1260,200,1,1,1
1935,Morris 41,Mesa Verde Black-on-white,181,1180,1280,100,1,1,1
1935,Morris 41,Moccasin Gray,2,800,980,180,0,1,0
1935,Morris 41,Nava Black-on-white,1,1100,1275,175,1,1,1
1935,Morris 41,Newcomb Black-on-white,2,875,1000,125,1,1,1
1935,Morris 41,"PII Gray Rim, Type Undifferentiated",24,900,1100,200,0,1,0
1935,Morris 41,"PII White Ware, Type Undifferentiated",7,900,1100,200,1,1,1
1935,Morris 41,"PII/PIII Gray Rim, Type Undifferentiated",14,900,1300,400,0,0,0
1935,Morris 41,"PIII White Ware, Type Undifferentiated",199,1100,1300,200,1,1,1
1935,Morris 41,"Plain Gray Ware, Undifferentiated",1,500,1300,800,0,0,0
1935,Morris 41,"Polychrome, Undifferentiated",1,700,1900,1200,0,1,1
1935,Morris 41,Puerco Black-on-red,5,1000,1175,175,1,1,1
1935,Morris 41,Red Mesa Black-on-white,9,880,1040,160,1,1,1
1935,Morris 41,"Red Ware type, Undifferentiated",11,700,1700,1000,0,0,0
1935,Morris 41,Reserve Black-on-white,5,1050,1200,150,1,1,1
1935,Morris 41,St. Johns Black-on-red,2,1200,1300,100,1,1,1
1935,Morris 41,Toadlena Black-on-white,1,975,1125,150,1,1,1
1935,Morris 41,Tsegi Red-on-orange,1,1200,1300,100,1,1,1
1935,Morris 41,"Type, Undifferentiated",7907,200,1900,1700,0,0,0
1935,Morris 41,"White Mountain type, Type Undifferentiated; Early",1,1000,1300,300,0,0,1
1935,Morris 41,"White ware, Undifferentiated",2552,550,1900,1350,0,0,1
1935,Morris 41,Wingate Black-on-red,5,1050,1225,175,1,1,1
1935,Morris 41,Wingate Polychrome,1,1100,1225,125,1,1,1
1942,Cerro Prieto--Quemado,"Cibola Black-on-white, Undifferentiated",38,550,1325,775,0,1,1
1942,Cerro Prieto--Quemado,Cibola Clapboard Corrugated Gray,36,900,1100,200,0,1,0
1942,Cerro Prieto--Quemado,"Cibola Gray Ware, Undifferentiated",5,550,1400,850,0,0,0
1942,Cerro Prieto--Quemado,Cibola Indented Corrugated Gray,41,1040,1400,360,0,0,0
1942,Cerro Prieto--Quemado,Cibola Plain Gray,135,550,1040,490,0,0,0
1942,Cerro Prieto--Quemado,"Cibola White Ware, Undifferentiated",54,550,1325,775,0,1,1
1942,Cerro Prieto--Quemado,Gallup Black-on-white,2,1040,1150,110,1,1,1
1942,Cerro Prieto--Quemado,Mogollon Plain Brown Ware,1,300,1400,1100,0,0,0
1942,Cerro Prieto--Quemado,Puerco Black-on-white,2,1030,1200,170,1,1,1
1942,Cerro Prieto--Quemado,Red Mesa Black-on-white,6,880,1040,160,1,1,1
1942,Cerro Prieto--Quemado,Reserve Black-on-white,22,1050,1200,150,1,1,1
1942,Cerro Prieto--Quemado,St. Johns Polychrome,5,1200,1300,100,1,1,1
1942,Cerro Prieto--Quemado,Tularosa Black-on-white,6,1180,1300,120,1,1,1
1942,Cerro Prieto--Quemado,"White Mountain type, Type Undifferentiated; Early",2,1000,1300,300,0,0,1
1946,Twin Towers,Abajo Red-on-orange,11,760,880,120,1,1,1
1946,Twin Towers,Blue Shale Corrugated,6,925,1150,225,0,0,0
1946,Twin Towers,Brimhall Black-on-white,2,1040,1150,110,1,1,1
1946,Twin Towers,Burnham Black-on-white,4,860,1000,140,1,1,1
1946,Twin Towers,Captain Tom Corrugated,5,890,1000,110,0,1,0
1946,Twin Towers,Chaco Black-on-white,2,1075,1150,75,1,1,1
1946,Twin Towers,Chapin Black-on-white,28,575,880,305,0,1,1
1946,Twin Towers,Chapin Gray,2,575,980,405,0,0,0
1946,Twin Towers,Chapin Gray Fugitive Red,41,575,980,405,0,0,0
1946,Twin Towers,Chuska Black-on-white,12,1040,1125,85,1,1,1
1946,Twin Towers,"Chuska Gray Ware, Type Undifferentiated",42,700,1300,600,0,0,0
1946,Twin Towers,"Chuska White Ware type, Undifferentiated",50,800,1300,500,0,1,1
1946,Twin Towers,"Cibola Corrugated Gray Ware, Undifferentiated",2,900,1400,500,0,0,0
1946,Twin Towers,"Cibola White Ware, Undifferentiated",7,550,1325,775,0,1,1
1946,Twin Towers,Citadel Polychrome,14,1040,1200,160,1,1,1
1946,Twin Towers,"Corrugated Gray Ware, Undifferentiated",20,800,1400,600,0,0,0
1946,Twin Towers,Cortez Black-on-white,20,880,1060,180,1,1,1
1946,Twin Towers,Crumbled House Black-on-white,1,1150,1300,150,1,1,1
1946,Twin Towers,Deadmans (La Plata) Black-on-red,32,880,1050,170,1,1,1
1946,Twin Towers,Flagstaff Black-on-white,2,1150,1220,70,1,1,1
1946,Twin Towers,Gallup Black-on-white,4,1040,1150,110,1,1,1
1946,Twin Towers,Gray Hills Banded,4,850,950,100,0,1,0
1946,Twin Towers,Hunter Corrugated,8,1100,1300,200,0,1,0
1946,Twin Towers,Kana'a Gray Ware,1,865,1060,195,0,1,0
1946,Twin Towers,Mancos Black-on-white,176,980,1180,200,1,1,1
1946,Twin Towers,Mancos Corrugated,72,920,1180,260,0,0,0
1946,Twin Towers,McElmo Black-on-white,133,1060,1260,200,1,1,1
1946,Twin Towers,Medicine Black-on-red,3,1040,1170,130,1,1,1
1946,Twin Towers,Mesa Verde Black-on-white,37,1180,1280,100,1,1,1
1946,Twin Towers,"Mesa Verde Corrugated Gray Ware, Undifferentiated",93,920,1280,360,0,0,0
1946,Twin Towers,"Mesa Verde Gray ware, Undifferentiated",324,575,1280,705,0,0,0
1946,Twin Towers,"Mesa Verde White Ware, Undifferentiated",627,575,1280,705,0,1,1
1946,Twin Towers,Moccasin Gray,5,800,980,180,0,1,0
1946,Twin Towers,Moenkopi Corrugated,1,1130,1250,120,0,1,0
1946,Twin Towers,Mummy Lake Gray,19,1150,1280,130,0,1,0
1946,Twin Towers,Nava Black-on-white,3,1100,1275,175,1,1,1
1946,Twin Towers,Newcomb Black-on-white,9,875,1000,125,1,1,1
1946,Twin Towers,"Orange Ware, Undifferentiated",44,1000,1350,350,0,0,0
1946,Twin Towers,Piedra Black-on-white,9,800,920,120,1,1,1
1946,Twin Towers,"Plain Gray Ware, Undifferentiated",29,500,1300,800,0,0,0
1946,Twin Towers,Puerco Black-on-red,2,1000,1175,175,1,1,1
1946,Twin Towers,Red Mesa Black-on-white,1,880,1040,160,1,1,1
1946,Twin Towers,"Red Ware type, Undifferentiated",2,700,1700,1000,0,0,0
1946,Twin Towers,"San Juan Red ware, Undifferentiated",83,700,1050,350,0,0,1
1946,Twin Towers,Taylor Black-on-white,1,1000,1100,100,1,1,1
1946,Twin Towers,Toadlena Black-on-white,9,975,1125,150,1,1,1
1946,Twin Towers,Tocito Gray,1,825,875,50,0,1,0
1946,Twin Towers,"Tsegi Orange Ware, Undifferentiated",107,1000,1300,300,1,0,1
1946,Twin Towers,Tsegi Red-on-orange,1,1200,1300,100,1,1,1
1946,Twin Towers,Tunicha Black-on-white,1,850,900,50,1,1,1
1946,Twin Towers,Tusayan A Polychrome,14,1110,1320,210,1,1,1
1946,Twin Towers,Tusayan B Polychrome,6,1110,1320,210,1,1,1
1946,Twin Towers,Tusayan Black-on-red,25,1045,1240,195,1,1,1
1946,Twin Towers,Tusayan Corrugated,6,1020,1275,255,0,0,0
1946,Twin Towers,"Tusayan Gray Ware, Undifferentiated",9,550,1285,735,0,0,0
1946,Twin Towers,"Tusayan White Ware, Undifferentiated",2,825,1300,475,0,1,1
1946,Twin Towers,"Type, Undifferentiated",71,200,1900,1700,0,0,0
1946,Twin Towers,"White Mountain type, Type Undifferentiated; Early",16,1000,1300,300,0,0,1
1946,Twin Towers,"White ware, Undifferentiated",96,550,1900,1350,0,0,1
1946,Twin Towers,Wingate Black-on-red,12,1050,1225,175,1,1,1
1967,Atsee Nitsaa,Cebolleta Black-on-white,10,1000,1200,200,1,1,1
1967,Atsee Nitsaa,Cibola Indented Corrugated Gray,1,1040,1400,360,0,0,0
1967,Atsee Nitsaa,Escavada Black-on-white,3,1000,1100,100,1,1,1
1967,Atsee Nitsaa,Gila Polychrome,1,1325,1450,125,1,1,1
1967,Atsee Nitsaa,Holbrook Black-on-white,2,1050,1150,100,1,1,1
1967,Atsee Nitsaa,Kiatuthlanna Black-on-white,2,850,925,75,1,1,1
1967,Atsee Nitsaa,Kiet Siel Black-on-red,1,1250,1320,70,1,1,1
1967,Atsee Nitsaa,Klagetoh Black-on-white,49,1250,1300,50,1,1,1
1967,Atsee Nitsaa,Klagetoh Black-on-yellow,5,1250,1300,50,1,1,1
1967,Atsee Nitsaa,Klagetoh Polychrome,3,1250,1325,75,1,1,1
1967,Atsee Nitsaa,Lino Gray (Tusayan),11,550,950,400,0,0,0
1967,Atsee Nitsaa,"Little Colorado Corrugated Gray Ware, Undifferentiated",69,1050,1250,200,0,1,0
1967,Atsee Nitsaa,Puerco Black-on-red,3,1000,1175,175,1,1,1
1967,Atsee Nitsaa,Puerco Black-on-white,46,1030,1200,170,1,1,1
1967,Atsee Nitsaa,Red Mesa Black-on-white,12,880,1040,160,1,1,1
1967,Atsee Nitsaa,St. Johns Polychrome,13,1200,1300,100,1,1,1
1967,Atsee Nitsaa,St. Josephs Black-on-White,2,825,1050,225,1,1,1
1967,Atsee Nitsaa,Tusayan Corrugated,13,1020,1275,255,0,0,0
1967,Atsee Nitsaa,"Type, Undifferentiated",38,200,1900,1700,0,0,0
1967,Atsee Nitsaa,White Mound Black-on-white,3,700,850,150,1,1,1
1967,Atsee Nitsaa,Wingate Black-on-red,15,1050,1225,175,1,1,1
1967,Atsee Nitsaa,Wingate Polychrome,19,1100,1225,125,1,1,1
1988,Cox Ranch,"Cibola Corrugated Gray Ware, Undifferentiated",26,900,1400,500,0,0,0
1988,Cox Ranch,Cibola Indented Corrugated Gray,3977,1040,1400,360,0,0,0
1988,Cox Ranch,Cibola Neckbanded Gray,2,850,1025,175,0,1,0
1988,Cox Ranch,Cibola Plain Corrugated Gray,178,900,1100,200,0,1,0
1988,Cox Ranch,Cibola Plain Gray,281,550,1040,490,0,0,0
1988,Cox Ranch,"Cibola White Ware, Undifferentiated",7455,550,1325,775,0,1,1
1988,Cox Ranch,Escavada Black-on-white,104,1000,1100,100,1,1,1
1988,Cox Ranch,Gallup Black-on-white,588,1040,1150,110,1,1,1
1988,Cox Ranch,Kiatuthlanna Black-on-white,25,850,925,75,1,1,1
1988,Cox Ranch,Lino Gray (Cibola),4,550,950,400,1,0,0
1988,Cox Ranch,"Mogollon Brown ware, Undifferentiated",96,900,1400,500,0,0,0
1988,Cox Ranch,Mogollon Indented Corrugated Brown Ware,3252,1000,1400,400,0,0,0
1988,Cox Ranch,"Mogollon Indented Corrugated Brown Ware, Smudged",1776,1000,1400,400,0,0,0
1988,Cox Ranch,Mogollon Patterned Corrugated Brown Ware,473,1000,1400,400,0,0,0
1988,Cox Ranch,"Mogollon Patterned Corrugated Brown Ware, Smudged",381,1000,1400,400,0,0,0
1988,Cox Ranch,Mogollon Plain Brown Ware,4483,300,1400,1100,0,0,0
1988,Cox Ranch,Mogollon Plain Corrugated Brown Ware,2811,900,1400,500,0,0,0
1988,Cox Ranch,"Mogollon Plain Corrugated Brown Ware, Smudged",998,900,1400,500,0,0,0
1988,Cox Ranch,Puerco Black-on-red,493,1000,1175,175,1,1,1
1988,Cox Ranch,Puerco Black-on-white,3570,1030,1200,170,1,1,1
1988,Cox Ranch,Red Mesa Black-on-white,107,880,1040,160,1,1,1
1988,Cox Ranch,Reserve Black-on-white,3945,1050,1200,150,1,1,1
1988,Cox Ranch,"White Mountain type, Type Undifferentiated; Early",731,1000,1300,300,0,0,1
1988,Cox Ranch,Wingate Black-on-red,730,1050,1225,175,1,1,1
1988,Cox Ranch,Wingate Polychrome,44,1100,1225,125,1,1,1
1989,Largo Gap,"Cibola Gray Ware, Undifferentiated",664,550,1400,850,0,0,0
1989,Largo Gap,Kiatuthlanna Black-on-white,6,850,925,75,1,1,1
1989,Largo Gap,"Mogollon Brown ware, Undifferentiated",2771,900,1400,500,0,0,0
1989,Largo Gap,"Mogollon Plain Brown Ware, Smudged",1935,300,1400,1100,0,0,0
1989,Largo Gap,Puerco Black-on-red,200,1000,1175,175,1,1,1
1989,Largo Gap,Puerco Black-on-white,1777,1030,1200,170,1,1,1
1989,Largo Gap,Red Mesa Black-on-white,19,880,1040,160,1,1,1
1989,Largo Gap,Reserve Black-on-white,1019,1050,1200,150,1,1,1
1989,Largo Gap,Wingate Black-on-red or Polychrome,428,1050,1225,175,1,1,1
2512,Tsintaa Yitilii,"Corrugated Gray Ware, Undifferentiated",1,800,1400,600,0,0,0
2512,Tsintaa Yitilii,Escavada Black-on-white,3,1000,1100,100,1,1,1
2512,Tsintaa Yitilii,Gallup Black-on-white,2,1040,1150,110,1,1,1
2512,Tsintaa Yitilii,Lino Gray (Cibola),1,550,950,400,1,0,0
2512,Tsintaa Yitilii,Moenkopi Corrugated,2,1130,1250,120,0,1,0
2512,Tsintaa Yitilii,"Plain Gray Ware, Undifferentiated",21,500,1300,800,0,0,0
2512,Tsintaa Yitilii,Red Mesa Black-on-white,1,880,1040,160,1,1,1
2512,Tsintaa Yitilii,Shato Black-on-white,1,1025,1150,125,1,1,1
2512,Tsintaa Yitilii,Sosi Black-on-white,2,1070,1180,110,1,1,1
2512,Tsintaa Yitilii,Tusayan Corrugated,21,1020,1275,255,0,0,0
2512,Tsintaa Yitilii,"White ware, Undifferentiated",2,550,1900,1350,0,0,1
2542,Plaza Site,Black Mesa Black-on-white,24,1000,1100,100,1,1,1
2542,Plaza Site,"Black-on-red, Undifferentiated",8,700,1700,1000,0,1,1
2542,Plaza Site,"Brown Corrugated Ware, Undifferentiated",256,800,1450,650,0,0,0
2542,Plaza Site,"Brown Ware, Undifferentiated",57,500,1450,950,0,0,0
2542,Plaza Site,Flagstaff Black-on-white,310,1150,1220,70,1,1,1
2542,Plaza Site,Holbrook B Black-on-white,174,1050,1150,100,1,1,1
2542,Plaza Site,Holbrook Black-on-white,175,1050,1150,100,1,1,1
2542,Plaza Site,"Little Colorado Corrugated Gray Ware, Undifferentiated",624,1050,1250,200,0,1,0
2542,Plaza Site,Little Colorado Indented Corrugated Gray,730,1050,1300,250,0,0,0
2542,Plaza Site,"Little Colorado White Ware, Undifferentiated",3086,825,1250,425,0,1,1
2542,Plaza Site,Moenkopi Corrugated,6,1130,1250,120,0,1,0
2542,Plaza Site,"Mogollon Brown ware, Undifferentiated",57,900,1400,500,0,0,0
2542,Plaza Site,Mogollon Indented Corrugated Brown Ware,102,1000,1400,400,0,0,0
2542,Plaza Site,"Mogollon Indented Corrugated Brown Ware, Smudged",154,1000,1400,400,0,0,0
2542,Plaza Site,Padre Black-on-white,662,1100,1250,150,1,1,1
2542,Plaza Site,Puerco Black-on-red,92,1000,1175,175,1,1,1
2542,Plaza Site,Showlow Black-on-red,30,1030,1200,170,1,1,1
2542,Plaza Site,Sosi Black-on-white,16,1070,1180,110,1,1,1
2542,Plaza Site,Tusayan Corrugated,704,1020,1275,255,0,0,0
2542,Plaza Site,Tusayan Plain Gray,693,600,1300,700,0,0,0
2542,Plaza Site,"Tusayan White Ware, Undifferentiated",26,825,1300,475,0,1,1
2542,Plaza Site,Walnut Black-on-white,4460,1100,1250,150,1,1,1
2542,Plaza Site,"White Mountain type, undifferentiated",8,1000,1450,450,0,0,1
2542,Plaza Site,"White ware, Undifferentiated",8,550,1900,1350,0,0,1
2542,Plaza Site,Wingate Black-on-red,48,1050,1225,175,1,1,1
2602,Dancing Rock GH,Abajo Red-on-orange,1,760,880,120,1,1,1
2602,Dancing Rock GH,Black Mesa Black-on-white,23,1000,1100,100,1,1,1
2602,Dancing Rock GH,"Chuska White Ware type, Undifferentiated",3,800,1300,500,0,1,1
2602,Dancing Rock GH,Citadel Polychrome,1,1040,1200,160,1,1,1
2602,Dancing Rock GH,Deadmans (La Plata) Black-on-red,5,880,1050,170,1,1,1
2602,Dancing Rock GH,Dogoszhi Black-on-white,16,1040,1210,170,1,1,1
2602,Dancing Rock GH,Holbrook Black-on-white,2,1050,1150,100,1,1,1
2602,Dancing Rock GH,Kana-a Black-on-white,13,825,1000,175,1,1,1
2602,Dancing Rock GH,Kana'a Gray Ware,1,865,1060,195,0,1,0
2602,Dancing Rock GH,Mancos Corrugated,6,920,1180,260,0,0,0
2602,Dancing Rock GH,Mesa Verde Black-on-white,2,1180,1280,100,1,1,1
2602,Dancing Rock GH,Moenkopi Corrugated,2,1130,1250,120,0,1,0
2602,Dancing Rock GH,"Plain Gray Ware, Undifferentiated",17,500,1300,800,0,0,0
2602,Dancing Rock GH,Red Mesa Black-on-white,17,880,1040,160,1,1,1
2602,Dancing Rock GH,Sikyatki Polychrome B,5,1385,1450,65,1,1,1
2602,Dancing Rock GH,Sosi Black-on-white,16,1070,1180,110,1,1,1
2602,Dancing Rock GH,Toadlena Black-on-white,3,975,1125,150,1,1,1
2602,Dancing Rock GH,Tsegi Orange,1,1250,1300,50,1,1,1
2602,Dancing Rock GH,Tusayan Black-on-red,2,1045,1240,195,1,1,1
2602,Dancing Rock GH,Tusayan Corrugated,30,1020,1275,255,0,0,0
2602,Dancing Rock GH,"Tusayan PIII White Ware, Type Undifferentiated",26,1100,1300,200,1,1,1
2602,Dancing Rock GH,Tusayan Polychrome,7,1110,1320,210,1,1,1
2602,Dancing Rock GH,Tusayan Wide Clapboard Gray,1,850,925,75,0,1,0
2602,Dancing Rock GH,Walnut Black-on-white,3,1100,1250,150,1,1,1
2602,Dancing Rock GH,White Mound Black-on-white,1,700,850,150,1,1,1
2602,Dancing Rock GH,"White ware, Undifferentiated",21,550,1900,1350,0,0,1
2856,South Ruin,"Cibola Black-on-white, Undifferentiated",6,550,1325,775,0,1,1
2856,South Ruin,"Cibola Corrugated Gray Ware, Undifferentiated",8,900,1400,500,0,0,0
2856,South Ruin,"Cibola White Ware, Undifferentiated",1,550,1325,775,0,1,1
2856,South Ruin,St. Johns Black-on-red,1,1200,1300,100,1,1,1
2856,South Ruin,St. Johns Polychrome,2,1200,1300,100,1,1,1
2856,South Ruin,Tularosa Black-on-white,2,1180,1300,120,1,1,1
2856,South Ruin,"White Mountain type, Type Undifferentiated; Early",1,1000,1300,300,0,0,1
2982,FSOP02 Great Kiva,"Cibola Black-on-white, Undifferentiated",27,550,1325,775,0,1,1
2982,FSOP02 Great Kiva,"Cibola Corrugated Gray Ware, Undifferentiated",2,900,1400,500,0,0,0
2982,FSOP02 Great Kiva,Cibola Indented Corrugated Gray,141,1040,1400,360,0,0,0
2982,FSOP02 Great Kiva,Cibola Plain Gray,14,550,1040,490,0,0,0
2982,FSOP02 Great Kiva,"Cibola White Ware, Undifferentiated",26,550,1325,775,0,1,1
2982,FSOP02 Great Kiva,Heshotauthla Polychrome,2,1275,1450,175,1,1,1
2982,FSOP02 Great Kiva,"Mogollon Brown ware, Undifferentiated",26,900,1400,500,0,0,0
2982,FSOP02 Great Kiva,Pinedale Black-on-red,1,1280,1330,50,1,1,1
2982,FSOP02 Great Kiva,Pinedale Black-on-white,8,1270,1320,50,1,1,1
2982,FSOP02 Great Kiva,Pinedale Polychrome,2,1290,1330,40,1,1,1
2982,FSOP02 Great Kiva,Puerco Black-on-red,2,1000,1175,175,1,1,1
2982,FSOP02 Great Kiva,Reserve Black-on-white,2,1050,1200,150,1,1,1
2982,FSOP02 Great Kiva,Socorro Black-on-white,1,1050,1300,250,1,1,1
2982,FSOP02 Great Kiva,Springerville Polychrome,1,1250,1300,50,1,1,1
2982,FSOP02 Great Kiva,St. Johns Polychrome,77,1200,1300,100,1,1,1
2982,FSOP02 Great Kiva,Tularosa Black-on-white,38,1180,1300,120,1,1,1
2982,FSOP02 Great Kiva,"White Mountain type, Type Undifferentiated; Early",178,1000,1300,300,0,0,1
2982,FSOP02 Great Kiva,Wingate Black-on-red,3,1050,1225,175,1,1,1
2982,FSOP02 Great Kiva,Wingate Polychrome,3,1100,1225,125,1,1,1
2997,Casa Mosca,Cebolleta Black-on-white,16,1000,1200,200,1,1,1
2997,Casa Mosca,Cibola Indented Corrugated Gray,173,1040,1400,360,0,0,0
2997,Casa Mosca,"Cibola White Ware, Undifferentiated",11,550,1325,775,0,1,1
2997,Casa Mosca,Gallup Black-on-white,1,1040,1150,110,1,1,1
2997,Casa Mosca,"Mogollon Indented Corrugated Brown Ware, Smudged",1,1000,1400,400,0,0,0
2997,Casa Mosca,"Mogollon Plain Brown Ware, Smudged",2,300,1400,1100,0,0,0
2997,Casa Mosca,Pinedale/Cedar Creek Polychrome,1,1290,1350,60,1,1,1
2997,Casa Mosca,Red Mesa Black-on-white,1,880,1040,160,1,1,1
2997,Casa Mosca,Socorro Black-on-white,3,1050,1300,250,1,1,1
2997,Casa Mosca,St. Johns Black-on-red,14,1200,1300,100,1,1,1
2997,Casa Mosca,St. Johns Polychrome,19,1200,1300,100,1,1,1
2997,Casa Mosca,Tularosa Black-on-white,38,1180,1300,120,1,1,1
2997,Casa Mosca,"White Mountain type, Type Undifferentiated; Early",14,1000,1300,300,0,0,1
2997,Casa Mosca,Wingate Black-on-red,13,1050,1225,175,1,1,1
2997,Casa Mosca,Wingate Polychrome,4,1100,1225,125,1,1,1
2999,Dittert Ranch,Alma Plain,10,300,1000,700,0,0,0
2999,Dittert Ranch,Cebolleta Black-on-white,3,1000,1200,200,1,1,1
2999,Dittert Ranch,Cibola Indented Corrugated Gray,43,1040,1400,360,0,0,0
2999,Dittert Ranch,"Cibola White Ware, Undifferentiated",14,550,1325,775,0,1,1
2999,Dittert Ranch,Mogollon Indented Corrugated Brown Ware,1,1000,1400,400,0,0,0
2999,Dittert Ranch,"Mogollon Indented Corrugated Brown Ware, Smudged",7,1000,1400,400,0,0,0
2999,Dittert Ranch,"Mogollon Plain Brown Ware, Smudged",3,300,1400,1100,0,0,0
2999,Dittert Ranch,Mogollon Plain Corrugated Brown Ware,4,900,1400,500,0,0,0
2999,Dittert Ranch,Socorro Black-on-white,1,1050,1300,250,1,1,1
2999,Dittert Ranch,St. Johns Black-on-red,2,1200,1300,100,1,1,1
2999,Dittert Ranch,Tularosa Black-on-white,2,1180,1300,120,1,1,1
2999,Dittert Ranch,"White Mountain type, Type Undifferentiated; Early",12,1000,1300,300,0,0,1
3000,LA 102391,Cebolleta Black-on-white,17,1000,1200,200,1,1,1
3000,LA 102391,"Cibola Corrugated Gray Ware, Undifferentiated",2,900,1400,500,0,0,0
3000,LA 102391,Cibola Indented Corrugated Gray,1,1040,1400,360,0,0,0
3000,LA 102391,Cibola Plain Gray,1,550,1040,490,0,0,0
3000,LA 102391,"Cibola White Ware, Undifferentiated",2,550,1325,775,0,1,1
3000,LA 102391,Gallup Black-on-white,1,1040,1150,110,1,1,1
3000,LA 102391,Mogollon Indented Corrugated Brown Ware,1,1000,1400,400,0,0,0
3000,LA 102391,Mogollon Plain Brown Ware,27,300,1400,1100,0,0,0
3000,LA 102391,"Mogollon Plain Brown Ware, Smudged",4,300,1400,1100,0,0,0
3000,LA 102391,Mogollon Plain Corrugated Brown Ware,15,900,1400,500,0,0,0
3000,LA 102391,"White ware, Undifferentiated",15,550,1900,1350,0,0,1
3001,LA 11670,Cebolleta Black-on-white,12,1000,1200,200,1,1,1
3001,LA 11670,"Cibola Corrugated Gray Ware, Undifferentiated",5,900,1400,500,0,0,0
3001,LA 11670,Cibola Indented Corrugated Gray,50,1040,1400,360,0,0,0
3001,LA 11670,"Cibola White Ware, Undifferentiated",29,550,1325,775,0,1,1
3001,LA 11670,Gallup Black-on-white,3,1040,1150,110,1,1,1
3001,LA 11670,Socorro Black-on-white,3,1050,1300,250,1,1,1
3001,LA 11670,St. Johns Black-on-red,5,1200,1300,100,1,1,1
3001,LA 11670,St. Johns Polychrome,7,1200,1300,100,1,1,1
3001,LA 11670,Tularosa Black-on-white,6,1180,1300,120,1,1,1
3001,LA 11670,"White Mountain type, Type Undifferentiated; Early",10,1000,1300,300,0,0,1
3001,LA 11670,Wingate Black-on-red,5,1050,1225,175,1,1,1
3002,Las Ventanas,Alma Plain,6,300,1000,700,0,0,0
3002,Las Ventanas,Cebolleta Black-on-white,72,1000,1200,200,1,1,1
3002,Las Ventanas,"Cibola Black-on-white, Undifferentiated",102,550,1325,775,0,1,1
3002,Las Ventanas,Cibola Clapboard Corrugated Gray,60,900,1100,200,0,1,0
3002,Las Ventanas,"Cibola Corrugated Gray Ware, Undifferentiated",20,900,1400,500,0,0,0
3002,Las Ventanas,"Cibola Gray Ware, Undifferentiated",4,550,1400,850,0,0,0
3002,Las Ventanas,Cibola Indented Corrugated Gray,280,1040,1400,360,0,0,0
3002,Las Ventanas,Cibola Neck Indented Corrugated,1,950,1025,75,0,1,0
3002,Las Ventanas,"Cibola PII Gray Ware, Type Undifferentiated",5,950,1100,150,0,1,0
3002,Las Ventanas,"Cibola PII/PIII Gray Ware, Type Undifferentiated",3,950,1300,350,0,0,0
3002,Las Ventanas,Cibola Plain Gray,463,550,1040,490,0,0,0
3002,Las Ventanas,"Cibola White Ware, Undifferentiated",80,550,1325,775,0,1,1
3002,Las Ventanas,Cibola Wide Neckbanded,4,850,925,75,0,1,0
3002,Las Ventanas,Escavada Black-on-white,5,1000,1100,100,1,1,1
3002,Las Ventanas,Gallup Black-on-white,9,1040,1150,110,1,1,1
3002,Las Ventanas,Kiatuthlanna Black-on-white,3,850,925,75,1,1,1
3002,Las Ventanas,"Mogollon Corrugated Brown Ware, Undifferentiated",11,800,1400,600,0,0,0
3002,Las Ventanas,Mogollon Indented Corrugated Brown Ware,8,1000,1400,400,0,0,0
3002,Las Ventanas,Mogollon Plain Brown Ware,158,300,1400,1100,0,0,0
3002,Las Ventanas,"Mogollon Plain Brown Ware, Smudged",4,300,1400,1100,0,0,0
3002,Las Ventanas,Mogollon Plain Corrugated Brown Ware,29,900,1400,500,0,0,0
3002,Las Ventanas,"Mogollon Plain Corrugated Brown Ware, Smudged",1,900,1400,500,0,0,0
3002,Las Ventanas,Puerco Black-on-red,9,1000,1175,175,1,1,1
3002,Las Ventanas,Puerco Black-on-white,17,1030,1200,170,1,1,1
3002,Las Ventanas,Red Mesa Black-on-white,9,880,1040,160,1,1,1
3002,Las Ventanas,Reserve Black-on-white,9,1050,1200,150,1,1,1
3002,Las Ventanas,Socorro Black-on-white,78,1050,1300,250,1,1,1
3002,Las Ventanas,Three Circle Neck Corrugated,3,800,1000,200,0,1,0
3002,Las Ventanas,"White Mountain type, Type Undifferentiated; Early",26,1000,1300,300,0,0,1
3002,Las Ventanas,Wingate Black-on-red,3,1050,1225,175,1,1,1
3004,5 Acre Ruin,Cortez Black-on-white,1,880,1060,180,1,1,1
3004,5 Acre Ruin,Deadmans (La Plata) Black-on-red,1,880,1050,170,1,1,1
3004,5 Acre Ruin,Dolores Corrugated,7,1100,1200,100,0,1,0
3004,5 Acre Ruin,Mancos Black-on-white,37,980,1180,200,1,1,1
3004,5 Acre Ruin,Mancos Corrugated,2,920,1180,260,0,0,0
3004,5 Acre Ruin,McElmo Black-on-white,50,1060,1260,200,1,1,1
3004,5 Acre Ruin,Mesa Verde Black-on-white,8,1180,1280,100,1,1,1
3004,5 Acre Ruin,Mesa Verde Corrugated,3,1100,1280,180,0,1,0
3004,5 Acre Ruin,"Mesa Verde PIII White Ware, Type Undifferentiated",46,1100,1280,180,1,1,1
3004,5 Acre Ruin,"White Mountain type, Type Undifferentiated; Early",1,1000,1300,300,0,0,1
3005,Albert Porter,Abajo Red-on-orange,14,760,880,120,1,1,1
3005,Albert Porter,Bluff Black-on-red,22,800,925,125,1,1,1
3005,Albert Porter,Chapin Black-on-white,12,575,880,305,0,1,1
3005,Albert Porter,Chapin Gray,25,575,980,405,0,0,0
3005,Albert Porter,Cortez Black-on-white,67,880,1060,180,1,1,1
3005,Albert Porter,Deadmans (La Plata) Black-on-red,40,880,1050,170,1,1,1
3005,Albert Porter,"Gray Ware, Undifferentiated",9,400,1400,1000,0,0,0
3005,Albert Porter,Mancos Black-on-white,3060,980,1180,200,1,1,1
3005,Albert Porter,Mancos Corrugated,214,920,1180,260,0,0,0
3005,Albert Porter,Mancos Gray,2,880,1060,180,0,1,0
3005,Albert Porter,McElmo Black-on-white,1371,1060,1260,200,1,1,1
3005,Albert Porter,Mesa Verde Black-on-white,436,1180,1280,100,1,1,1
3005,Albert Porter,"Mesa Verde BMIII/PI White Ware, Type Undifferentiated",287,575,920,345,0,1,1
3005,Albert Porter,Mesa Verde Corrugated,484,1100,1280,180,0,1,0
3005,Albert Porter,"Mesa Verde Corrugated Gray Ware, Undifferentiated",28462,920,1280,360,0,0,0
3005,Albert Porter,"Mesa Verde PII White Ware, Type Undifferentiated",474,920,1100,180,1,1,1
3005,Albert Porter,"Mesa Verde PII/PIII White Ware, Type Undifferentiated",14931,920,1280,360,0,1,1
3005,Albert Porter,"Mesa Verde PIII White Ware, Type Undifferentiated",1816,1100,1280,180,1,1,1
3005,Albert Porter,Mesa Verde Plain Gray,3698,575,1020,445,0,0,0
3005,Albert Porter,Moccasin Gray,6,800,980,180,0,1,0
3005,Albert Porter,Piedra Black-on-white,15,800,920,120,1,1,1
3005,Albert Porter,"Red Ware type, Undifferentiated",14,700,1700,1000,0,0,0
3005,Albert Porter,"San Juan Red ware, Undifferentiated",62,700,1050,350,0,0,1
3005,Albert Porter,"White ware, Undifferentiated",18,550,1900,1350,0,0,1
3006,Allentown,"Cibola BMIII/PI White Ware, Type Undifferentiated",1,550,900,350,0,1,1
3006,Allentown,Cibola Indented Corrugated Gray,37,1040,1400,360,0,0,0
3006,Allentown,Cibola Neckbanded Gray,1,850,1025,175,0,1,0
3006,Allentown,"Cibola PII/PIII White Ware, Type Undifferentiated",10,1000,1300,300,1,1,1
3006,Allentown,Cibola Plain Gray,716,550,1040,490,0,0,0
3006,Allentown,"Cibola White Ware, Undifferentiated",5,550,1325,775,0,1,1
3006,Allentown,Escavada Black-on-white,1,1000,1100,100,1,1,1
3006,Allentown,Gallup Black-on-white,3,1040,1150,110,1,1,1
3006,Allentown,"Gray Ware, Undifferentiated",2,400,1400,1000,0,0,0
3006,Allentown,Klagetoh Black-on-yellow,3,1250,1300,50,1,1,1
3006,Allentown,Lino Black-on-gray (Cibola),1,600,850,250,1,1,1
3006,Allentown,Lino Gray (Cibola),56,550,950,400,1,0,0
3006,Allentown,Lino Gray Fugitive Red [Cibola Series],1,550,850,300,1,0,0
3006,Allentown,Padre Black-on-white,1,1100,1250,150,1,1,1
3006,Allentown,Red Mesa Black-on-white,1,880,1040,160,1,1,1
3006,Allentown,Reserve Black-on-white,7,1050,1200,150,1,1,1
3006,Allentown,Springerville Polychrome,1,1250,1300,50,1,1,1
3006,Allentown,St. Johns Black-on-red,7,1200,1300,100,1,1,1
3006,Allentown,St. Johns Polychrome,5,1200,1300,100,1,1,1
3006,Allentown,Tularosa Black-on-white,9,1180,1300,120,1,1,1
3006,Allentown,White Mound Black-on-white,1,700,850,150,1,1,1
3006,Allentown,"White Mountain type, Type Undifferentiated; Early",2,1000,1300,300,0,0,1
3006,Allentown,Wingate Polychrome,1,1100,1225,125,1,1,1
3006,Allentown,Woodruff Smudged,3,500,1100,600,0,0,0
3007,Andrews,Chaco Black-on-white,4,1075,1150,75,1,1,1
3007,Andrews,Cibola Clapboard Corrugated Gray,122,900,1100,200,0,1,0
3007,Andrews,"Cibola Corrugated Gray Ware, Undifferentiated",21,900,1400,500,0,0,0
3007,Andrews,Cibola Indented Corrugated Gray,337,1040,1400,360,0,0,0
3007,Andrews,Cibola Neckbanded Gray,22,850,1025,175,0,1,0
3007,Andrews,"Cibola PI/PII White Ware, Type Undifferentiated",2,700,1100,400,0,1,1
3007,Andrews,"Cibola PII White Ware, Type Undifferentiated",139,880,1100,220,1,1,1
3007,Andrews,Cibola Plain Gray,908,550,1040,490,0,0,0
3007,Andrews,"Cibola White Ware, Undifferentiated",91,550,1325,775,0,1,1
3007,Andrews,Escavada Black-on-white,27,1000,1100,100,1,1,1
3007,Andrews,Gallup Black-on-white,49,1040,1150,110,1,1,1
3007,Andrews,Kiatuthlanna Black-on-white,55,850,925,75,1,1,1
3007,Andrews,"Plain Gray Ware, Undifferentiated",6,500,1300,800,0,0,0
3007,Andrews,Puerco Black-on-red,12,1000,1175,175,1,1,1
3007,Andrews,Puerco Black-on-white,18,1030,1200,170,1,1,1
3007,Andrews,Red Mesa Black-on-white,85,880,1040,160,1,1,1
3007,Andrews,"White Mountain type, Type Undifferentiated; Early",12,1000,1300,300,0,0,1
3007,Andrews,"White ware, Undifferentiated",189,550,1900,1350,0,0,1
3009,Ansell Hall,Abajo Red-on-orange,2,760,880,120,1,1,1
3009,Ansell Hall,"Brown Ware, Undifferentiated",3,500,1450,950,0,0,0
3009,Ansell Hall,Kana'a Gray Ware,4,865,1060,195,0,1,0
3009,Ansell Hall,Lino Black-on-gray (Tusayan),1,600,850,250,1,1,1
3009,Ansell Hall,Mancos Black-on-white,274,980,1180,200,1,1,1
3009,Ansell Hall,McElmo Black-on-white,1,1060,1260,200,1,1,1
3009,Ansell Hall,"Mesa Verde Corrugated Gray Ware, Undifferentiated",652,920,1280,360,0,0,0
3009,Ansell Hall,"Mesa Verde Gray ware, Undifferentiated",20,575,1280,705,0,0,0
3009,Ansell Hall,"Mesa Verde White Ware, Undifferentiated",273,575,1280,705,0,1,1
3009,Ansell Hall,"Red Ware type, Undifferentiated",13,700,1700,1000,0,0,0
3009,Ansell Hall,Tusayan Black-on-red,1,1045,1240,195,1,1,1
3009,Ansell Hall,"White ware, Undifferentiated",6,550,1900,1350,0,0,1
3017,Arch Canyon,Bluff Black-on-red,8,800,925,125,1,1,1
3017,Arch Canyon,Chapin Gray,1,575,980,405,0,0,0
3017,Arch Canyon,Deadmans (La Plata) Black-on-red,2,880,1050,170,1,1,1
3017,Arch Canyon,Dolores Corrugated,1,1100,1200,100,0,1,0
3017,Arch Canyon,Mancos Corrugated,1,920,1180,260,0,0,0
3017,Arch Canyon,Mancos Gray,8,880,1060,180,0,1,0
3017,Arch Canyon,Mesa Verde Corrugated,26,1100,1280,180,0,1,0
3017,Arch Canyon,"Mesa Verde PII/PIII White Ware, Type Undifferentiated",18,920,1280,360,0,1,1
3017,Arch Canyon,Mesa Verde Plain Gray,60,575,1020,445,0,0,0
3017,Arch Canyon,Moccasin Gray,7,800,980,180,0,1,0
3017,Arch Canyon,"San Juan Red ware, Undifferentiated",4,700,1050,350,0,0,1
3017,Arch Canyon,Tusayan Black-on-red,1,1045,1240,195,1,1,1
3017,Arch Canyon,White Mesa Black-on-white,2,850,1000,150,1,1,1
3017,Arch Canyon,"White ware, Undifferentiated",4,550,1900,1350,0,0,1
3020,AZ P:11:124 (ASU),Black Mesa Black-on-white,7,1000,1100,100,1,1,1
3020,AZ P:11:124 (ASU),Flagstaff Black-on-white,4,1150,1220,70,1,1,1
3020,AZ P:11:124 (ASU),Homolovi Black-on-red,1,1300,1400,100,1,1,1
3020,AZ P:11:124 (ASU),Kayenta Black-on-white,5,1250,1300,50,1,1,1
3020,AZ P:11:124 (ASU),"Mogollon Brown ware, Undifferentiated",25,900,1400,500,0,0,0
3020,AZ P:11:124 (ASU),"Mogollon Corrugated Brown Ware, Undifferentiated",50,800,1400,600,0,0,0
3020,AZ P:11:124 (ASU),Reserve Black-on-white,21,1050,1200,150,1,1,1
3020,AZ P:11:124 (ASU),Sosi Black-on-white,12,1070,1180,110,1,1,1
3020,AZ P:11:124 (ASU),St. Johns Black-on-red,1,1200,1300,100,1,1,1
3020,AZ P:11:124 (ASU),Tularosa Black-on-white,7,1180,1300,120,1,1,1
3020,AZ P:11:124 (ASU),"White ware, Undifferentiated",120,550,1900,1350,0,0,1
3021,AZ P:11:130 (ASU),Black Mesa Black-on-white,3,1000,1100,100,1,1,1
3021,AZ P:11:130 (ASU),Dogoszhi Black-on-white,1,1040,1210,170,1,1,1
3021,AZ P:11:130 (ASU),Flagstaff Black-on-white,2,1150,1220,70,1,1,1
3021,AZ P:11:130 (ASU),Kana-a Black-on-white,2,825,1000,175,1,1,1
3021,AZ P:11:130 (ASU),Kayenta Black-on-white,3,1250,1300,50,1,1,1
3021,AZ P:11:130 (ASU),"Mogollon Brown ware, Undifferentiated",18,900,1400,500,0,0,0
3021,AZ P:11:130 (ASU),"Mogollon Corrugated Brown Ware, Undifferentiated",75,800,1400,600,0,0,0
3021,AZ P:11:130 (ASU),Reserve Black-on-white,17,1050,1200,150,1,1,1
3021,AZ P:11:130 (ASU),"Roosevelt Red Ware type, Undifferentiated",4,1275,1450,175,0,0,0
3021,AZ P:11:130 (ASU),Sosi Black-on-white,18,1070,1180,110,1,1,1
3021,AZ P:11:130 (ASU),St. Johns Black-on-red,1,1200,1300,100,1,1,1
3021,AZ P:11:130 (ASU),Tularosa Black-on-white,7,1180,1300,120,1,1,1
3021,AZ P:11:130 (ASU),"White ware, Undifferentiated",31,550,1900,1350,0,0,1
3022,AZ P:11:55 (ASU),Black Mesa Black-on-white,4,1000,1100,100,1,1,1
3022,AZ P:11:55 (ASU),Flagstaff Black-on-white,3,1150,1220,70,1,1,1
3022,AZ P:11:55 (ASU),Kayenta Black-on-white,3,1250,1300,50,1,1,1
3022,AZ P:11:55 (ASU),"Mogollon Brown ware, Undifferentiated",6,900,1400,500,0,0,0
3022,AZ P:11:55 (ASU),"Mogollon Corrugated Brown Ware, Undifferentiated",22,800,1400,600,0,0,0
3022,AZ P:11:55 (ASU),Reserve Black-on-white,8,1050,1200,150,1,1,1
3022,AZ P:11:55 (ASU),Sosi Black-on-white,8,1070,1180,110,1,1,1
3022,AZ P:11:55 (ASU),St. Johns Black-on-red,2,1200,1300,100,1,1,1
3022,AZ P:11:55 (ASU),Tularosa Black-on-white,3,1180,1300,120,1,1,1
3022,AZ P:11:55 (ASU),"White ware, Undifferentiated",2,550,1900,1350,0,0,1
3023,AZ P:11:57 (ASU),Black Mesa Black-on-white,9,1000,1100,100,1,1,1
3023,AZ P:11:57 (ASU),Flagstaff Black-on-white,2,1150,1220,70,1,1,1
3023,AZ P:11:57 (ASU),"Mogollon Brown ware, Undifferentiated",16,900,1400,500,0,0,0
3023,AZ P:11:57 (ASU),"Mogollon Corrugated Brown Ware, Undifferentiated",20,800,1400,600,0,0,0
3023,AZ P:11:57 (ASU),Reserve Black-on-white,15,1050,1200,150,1,1,1
3023,AZ P:11:57 (ASU),Sosi Black-on-white,9,1070,1180,110,1,1,1
3023,AZ P:11:57 (ASU),"White ware, Undifferentiated",58,550,1900,1350,0,0,1
3024,AZ P:12:105 (ASU),Black Mesa Black-on-white,25,1000,1100,100,1,1,1
3024,AZ P:12:105 (ASU),Dogoszhi Black-on-white,2,1040,1210,170,1,1,1
3024,AZ P:12:105 (ASU),Flagstaff Black-on-white,6,1150,1220,70,1,1,1
3024,AZ P:12:105 (ASU),Gila Black-on-red,8,1300,1375,75,1,1,1
3024,AZ P:12:105 (ASU),Kana-a Black-on-white,2,825,1000,175,1,1,1
3024,AZ P:12:105 (ASU),Kayenta Black-on-white,14,1250,1300,50,1,1,1
3024,AZ P:12:105 (ASU),"Mogollon Brown ware, Undifferentiated",56,900,1400,500,0,0,0
3024,AZ P:12:105 (ASU),"Mogollon Corrugated Brown Ware, Undifferentiated",100,800,1400,600,0,0,0
3024,AZ P:12:105 (ASU),Pinedale Black-on-red,2,1280,1330,50,1,1,1
3024,AZ P:12:105 (ASU),Reserve Black-on-white,19,1050,1200,150,1,1,1
3024,AZ P:12:105 (ASU),"Roosevelt Red Ware type, Undifferentiated",2,1275,1450,175,0,0,0
3024,AZ P:12:105 (ASU),Sosi Black-on-white,34,1070,1180,110,1,1,1
3024,AZ P:12:105 (ASU),St. Johns Black-on-red,13,1200,1300,100,1,1,1
3024,AZ P:12:105 (ASU),St. Johns Polychrome,3,1200,1300,100,1,1,1
3024,AZ P:12:105 (ASU),Tularosa Black-on-white,9,1180,1300,120,1,1,1
3024,AZ P:12:105 (ASU),"White ware, Undifferentiated",87,550,1900,1350,0,0,1
3026,AZ P:12:404 (ASM),Black Mesa Black-on-white,4,1000,1100,100,1,1,1
3026,AZ P:12:404 (ASM),Kana-a Black-on-white,5,825,1000,175,1,1,1
3026,AZ P:12:404 (ASM),"Mogollon Brown ware, Undifferentiated",267,900,1400,500,0,0,0
3026,AZ P:12:404 (ASM),"Mogollon Corrugated Brown Ware, Undifferentiated",4,800,1400,600,0,0,0
3026,AZ P:12:404 (ASM),"White ware, Undifferentiated",37,550,1900,1350,0,0,1
3027,AZ P:12:76 (ASU),Black Mesa Black-on-white,14,1000,1100,100,1,1,1
3027,AZ P:12:76 (ASU),Dogoszhi Black-on-white,1,1040,1210,170,1,1,1
3027,AZ P:12:76 (ASU),Flagstaff Black-on-white,2,1150,1220,70,1,1,1
3027,AZ P:12:76 (ASU),Kana-a Black-on-white,4,825,1000,175,1,1,1
3027,AZ P:12:76 (ASU),Kayenta Black-on-white,5,1250,1300,50,1,1,1
3027,AZ P:12:76 (ASU),"Mogollon Brown ware, Undifferentiated",25,900,1400,500,0,0,0
3027,AZ P:12:76 (ASU),"Mogollon Corrugated Brown Ware, Undifferentiated",43,800,1400,600,0,0,0
3027,AZ P:12:76 (ASU),Reserve Black-on-white,15,1050,1200,150,1,1,1
3027,AZ P:12:76 (ASU),Showlow Black-on-red,2,1030,1200,170,1,1,1
3027,AZ P:12:76 (ASU),Sosi Black-on-white,26,1070,1180,110,1,1,1
3027,AZ P:12:76 (ASU),St. Johns Black-on-red,1,1200,1300,100,1,1,1
3027,AZ P:12:76 (ASU),St. Johns Polychrome,1,1200,1300,100,1,1,1
3027,AZ P:12:76 (ASU),Tularosa Black-on-white,2,1180,1300,120,1,1,1
3027,AZ P:12:76 (ASU),"White ware, Undifferentiated",55,550,1900,1350,0,0,1
3028,AZ P:12:99 (ASU),Black Mesa Black-on-white,24,1000,1100,100,1,1,1
3028,AZ P:12:99 (ASU),Flagstaff Black-on-white,7,1150,1220,70,1,1,1
3028,AZ P:12:99 (ASU),Gila Black-on-red,2,1300,1375,75,1,1,1
3028,AZ P:12:99 (ASU),Kana-a Black-on-white,3,825,1000,175,1,1,1
3028,AZ P:12:99 (ASU),Kayenta Black-on-white,11,1250,1300,50,1,1,1
3028,AZ P:12:99 (ASU),"Mogollon Brown ware, Undifferentiated",129,900,1400,500,0,0,0
3028,AZ P:12:99 (ASU),"Mogollon Corrugated Brown Ware, Undifferentiated",174,800,1400,600,0,0,0
3028,AZ P:12:99 (ASU),"Red Ware type, Undifferentiated",1,700,1700,1000,0,0,0
3028,AZ P:12:99 (ASU),Reserve Black-on-white,25,1050,1200,150,1,1,1
3028,AZ P:12:99 (ASU),"Roosevelt Red Ware type, Undifferentiated",1,1275,1450,175,0,0,0
3028,AZ P:12:99 (ASU),Showlow Black-on-red,16,1030,1200,170,1,1,1
3028,AZ P:12:99 (ASU),Sosi Black-on-white,32,1070,1180,110,1,1,1
3028,AZ P:12:99 (ASU),St. Johns Black-on-red,42,1200,1300,100,1,1,1
3028,AZ P:12:99 (ASU),St. Johns Polychrome,5,1200,1300,100,1,1,1
3028,AZ P:12:99 (ASU),Tularosa Black-on-white,7,1180,1300,120,1,1,1
3028,AZ P:12:99 (ASU),"White ware, Undifferentiated",68,550,1900,1350,0,0,1
3030,AZ P:16:160 (ASM),"Cibola Gray Ware, Undifferentiated",6,550,1400,850,0,0,0
3030,AZ P:16:160 (ASM),"Cibola White Ware, Undifferentiated",105,550,1325,775,0,1,1
3030,AZ P:16:160 (ASM),Escavada Black-on-white,2,1000,1100,100,1,1,1
3030,AZ P:16:160 (ASM),"Little Colorado White Ware, Undifferentiated",8,825,1250,425,0,1,1
3030,AZ P:16:160 (ASM),"Mogollon Brown ware, Undifferentiated",29,900,1400,500,0,0,0
3030,AZ P:16:160 (ASM),"Mogollon Corrugated Brown Ware, Undifferentiated",35,800,1400,600,0,0,0
3030,AZ P:16:160 (ASM),Mogollon Indented Corrugated Brown Ware,338,1000,1400,400,0,0,0
3030,AZ P:16:160 (ASM),"Mogollon Indented Corrugated Brown Ware, Smudged",5,1000,1400,400,0,0,0
3030,AZ P:16:160 (ASM),Mogollon Obliterated Corrugated Brown,1,1000,1400,400,0,0,0
3030,AZ P:16:160 (ASM),"Mogollon Obliterated Corrugated Brown Ware, Smudged",1,1000,1400,400,0,0,0
3030,AZ P:16:160 (ASM),Mogollon Patterned Corrugated Brown Ware,5,1000,1400,400,0,0,0
3030,AZ P:16:160 (ASM),Mogollon Plain Brown Ware,20,300,1400,1100,0,0,0
3030,AZ P:16:160 (ASM),"Mogollon Plain Brown Ware, Smudged",3,300,1400,1100,0,0,0
3030,AZ P:16:160 (ASM),Mogollon Zoned Corrugated Brown Ware,4,1000,1400,400,0,0,0
3030,AZ P:16:160 (ASM),"PII/PIII White Ware, Type Undifferentiated",53,900,1300,400,0,1,1
3030,AZ P:16:160 (ASM),Puerco Black-on-white,5,1030,1200,170,1,1,1
3030,AZ P:16:160 (ASM),"Puerco Valley Red Ware, Undifferentiated",11,1000,1200,200,0,1,0
3030,AZ P:16:160 (ASM),Red Mesa Black-on-white,2,880,1040,160,1,1,1
3030,AZ P:16:160 (ASM),Reserve Black-on-white,124,1050,1200,150,1,1,1
3030,AZ P:16:160 (ASM),Showlow Black-on-red Corrugated,1,1050,1200,150,1,1,1
3030,AZ P:16:160 (ASM),Showlow Red,1,1000,1100,100,0,1,0
3030,AZ P:16:160 (ASM),Showlow Red Corrugated,6,1030,1280,250,0,0,0
3030,AZ P:16:160 (ASM),Snowflake Black-on-white,1,1100,1275,175,1,1,1
3030,AZ P:16:160 (ASM),"Tusayan Gray Ware, Undifferentiated",1,550,1285,735,0,0,0
3030,AZ P:16:160 (ASM),"Tusayan White Ware, Undifferentiated",1,825,1300,475,0,1,1
3030,AZ P:16:160 (ASM),Woodruff Brown,10,500,1100,600,0,0,0
3032,AZ Q:13:1 (ASU),"Cibola White Ware, Undifferentiated",113,550,1325,775,0,1,1
3032,AZ Q:13:1 (ASU),Mogollon Indented Corrugated Brown Ware,91,1000,1400,400,0,0,0
3032,AZ Q:13:1 (ASU),Mogollon Obliterated Corrugated Brown,2,1000,1400,400,0,0,0
3032,AZ Q:13:1 (ASU),Mogollon Patterned Corrugated Brown Ware,1,1000,1400,400,0,0,0
3032,AZ Q:13:1 (ASU),Mogollon Plain Brown Ware,888,300,1400,1100,0,0,0
3032,AZ Q:13:1 (ASU),Mogollon Plain Corrugated Brown Ware,30,900,1400,500,0,0,0
3033,AZ Q:3:64 (ASM),Alma Plain,1,300,1000,700,0,0,0
3033,AZ Q:3:64 (ASM),"Cibola Late Corrugated Ware, Type Undifferentiated",1,1200,1400,200,0,1,0
3033,AZ Q:3:64 (ASM),"Corrugated Gray Ware, Undifferentiated",2,800,1400,600,0,0,0
3033,AZ Q:3:64 (ASM),Kana'a Gray Ware,1,865,1060,195,0,1,0
3033,AZ Q:3:64 (ASM),Kiatuthlanna Black-on-white,4,850,925,75,1,1,1
3033,AZ Q:3:64 (ASM),Lino Gray (Cibola),22,550,950,400,1,0,0
3033,AZ Q:3:64 (ASM),"Plain Gray Ware, Undifferentiated",3,500,1300,800,0,0,0
3033,AZ Q:3:64 (ASM),Puerco Black-on-white,3,1030,1200,170,1,1,1
3033,AZ Q:3:64 (ASM),Red Mesa Black-on-white,1,880,1040,160,1,1,1
3033,AZ Q:3:64 (ASM),Reserve Black-on-white,1,1050,1200,150,1,1,1
3033,AZ Q:3:64 (ASM),Tularosa Black-on-white,2,1180,1300,120,1,1,1
3033,AZ Q:3:64 (ASM),"White ware, Undifferentiated",1,550,1900,1350,0,0,1
3035,Bad Dog Ridge,Black Mesa Black-on-white,8,1000,1100,100,1,1,1
3035,Bad Dog Ridge,Dogoszhi Black-on-white,4,1040,1210,170,1,1,1
3035,Bad Dog Ridge,Escavada Black-on-white,14,1000,1100,100,1,1,1
3035,Bad Dog Ridge,Gallup Black-on-white,56,1040,1150,110,1,1,1
3035,Bad Dog Ridge,Holbrook A Black-on-white,4,1050,1150,100,1,1,1
3035,Bad Dog Ridge,Holbrook B Black-on-white,16,1050,1150,100,1,1,1
3035,Bad Dog Ridge,Leupp Black-on-white,2,1200,1250,50,1,1,1
3035,Bad Dog Ridge,Red Mesa Black-on-white,8,880,1040,160,1,1,1
3035,Bad Dog Ridge,"Red Ware type, Undifferentiated",2,700,1700,1000,0,0,0
3035,Bad Dog Ridge,Reserve Black-on-white,2,1050,1200,150,1,1,1
3035,Bad Dog Ridge,Showlow Black-on-red,6,1030,1200,170,1,1,1
3035,Bad Dog Ridge,Showlow Red Corrugated,2,1030,1280,250,0,0,0
3035,Bad Dog Ridge,Sosi Black-on-white,4,1070,1180,110,1,1,1
3035,Bad Dog Ridge,St. Johns Polychrome,2,1200,1300,100,1,1,1
3035,Bad Dog Ridge,Tusayan Black-on-white,36,1200,1300,100,1,1,1
3035,Bad Dog Ridge,Wingate Black-on-red,4,1050,1225,175,1,1,1
3035,Bad Dog Ridge,Wingate Polychrome,4,1100,1225,125,1,1,1
3037,Badger House,Bluff Black-on-red,837,800,925,125,1,1,1
3037,Badger House,"Brown Ware, Undifferentiated",7,500,1450,950,0,0,0
3037,Badger House,Chapin Black-on-white,451,575,880,305,0,1,1
3037,Badger House,Chapin Gray,29393,575,980,405,0,0,0
3037,Badger House,Cortez Black-on-white,25,880,1060,180,1,1,1
3037,Badger House,Deadmans (La Plata) Black-on-red,1,880,1050,170,1,1,1
3037,Badger House,Kana-a Black-on-white,2,825,1000,175,1,1,1
3037,Badger House,Mancos Black-on-white,59,980,1180,200,1,1,1
3037,Badger House,Mancos Corrugated,28,920,1180,260,0,0,0
3037,Badger House,Mancos Gray,11,880,1060,180,0,1,0
3037,Badger House,McElmo Black-on-white,13,1060,1260,200,1,1,1
3037,Badger House,Mesa Verde Black-on-white,34,1180,1280,100,1,1,1
3037,Badger House,"Mesa Verde PI White Ware, Type Undifferentiated",616,750,920,170,1,1,1
3037,Badger House,Moccasin Gray,1573,800,980,180,0,1,0
3037,Badger House,Piedra Black-on-white,275,800,920,120,1,1,1
3037,Badger House,"Plain Brown Smudged, Undifferentiated",2,400,1450,1050,0,0,0
3037,Badger House,"Red Ware type, Undifferentiated",1,700,1700,1000,0,0,0
3037,Badger House,"San Juan Red ware, Undifferentiated",592,700,1050,350,0,0,1
3037,Badger House,Tusayan Polychrome,1,1110,1320,210,1,1,1
3037,Badger House,"Type, Undifferentiated",158,200,1900,1700,0,0,0
3037,Badger House,Woodruff Red Smudged,1,400,1100,700,0,0,0
3039,Bancos Village,Arboles Black-on-white,13,950,1050,100,1,1,1
3039,Bancos Village,Chapin Gray,2,575,980,405,0,0,0
3039,Bancos Village,Cortez Black-on-white,1,880,1060,180,1,1,1
3039,Bancos Village,Deadmans (La Plata) Black-on-red,2,880,1050,170,1,1,1
3039,Bancos Village,Kana-a Black-on-white,6,825,1000,175,1,1,1
3039,Bancos Village,Moccasin Gray,1,800,980,180,0,1,0
3039,Bancos Village,Piedra Black-on-white,12,800,920,120,1,1,1
3039,Bancos Village,Rosa Black-on-white,2,700,875,175,1,1,1
3039,Bancos Village,Rosa Gray,257,700,1000,300,0,0,0
3039,Bancos Village,Rosa Neckbanded,1,775,900,125,0,1,0
3039,Bancos Village,"Sambrito Utility Ware, Undifferentiated",3,300,700,400,0,0,0
3039,Bancos Village,"San Juan Red ware, Undifferentiated",1,700,1050,350,0,0,1
3040,Bee Burrow,Chaco-McElmo Black-on-white (carbon paint),4,1090,1175,85,1,1,1
3040,Bee Burrow,Chuska Indented Corrugated Gray,2,1040,1300,260,0,0,0
3040,Bee Burrow,Cibola Indented Corrugated Gray,142,1040,1400,360,0,0,0
3040,Bee Burrow,Cibola Plain Gray,7,550,1040,490,0,0,0
3040,Bee Burrow,"Cibola White Ware, Undifferentiated",40,550,1325,775,0,1,1
3040,Bee Burrow,Escavada Black-on-white,17,1000,1100,100,1,1,1
3040,Bee Burrow,Gallup Black-on-white,11,1040,1150,110,1,1,1
3040,Bee Burrow,Puerco Black-on-red,3,1000,1175,175,1,1,1
3040,Bee Burrow,Red Mesa Black-on-white,1,880,1040,160,1,1,1
3040,Bee Burrow,"White Mountain type, Type Undifferentiated; Early",7,1000,1300,300,0,0,1
3040,Bee Burrow,Wingate Black-on-red,1,1050,1225,175,1,1,1
3043,Beth's Great Kiva,Black Mesa Black-on-white,11,1000,1100,100,1,1,1
3043,Beth's Great Kiva,Chaco Black-on-white,6,1075,1150,75,1,1,1
3043,Beth's Great Kiva,"Chuska Clapboard Corrugated Gray, Undifferentiated",12,900,1100,200,0,1,0
3043,Beth's Great Kiva,Chuska Indented Corrugated Gray,4,1040,1300,260,0,0,0
3043,Beth's Great Kiva,"Chuska Plain Gray Ware, Type Undifferentiated",99,700,925,225,0,0,0
3043,Beth's Great Kiva,"Chuska White Ware type, Undifferentiated",16,800,1300,500,0,1,1
3043,Beth's Great Kiva,"Cibola Black-on-white, Undifferentiated",1285,550,1325,775,0,1,1
3043,Beth's Great Kiva,"Cibola Corrugated Gray Ware, Undifferentiated",320,900,1400,500,0,0,0
3043,Beth's Great Kiva,Cibola Indented Corrugated Gray,43,1040,1400,360,0,0,0
3043,Beth's Great Kiva,Cibola Neckbanded Gray,7,850,1025,175,0,1,0
3043,Beth's Great Kiva,"Cibola PII White Ware, Type Undifferentiated",4,880,1100,220,1,1,1
3043,Beth's Great Kiva,Cibola Plain Gray,9194,550,1040,490,0,0,0
3043,Beth's Great Kiva,"Cibola White Ware, Undifferentiated",494,550,1325,775,0,1,1
3043,Beth's Great Kiva,Deadmans (La Plata) Black-on-red,9,880,1050,170,1,1,1
3043,Beth's Great Kiva,Drolet Black-on-white,2,900,1000,100,1,1,1
3043,Beth's Great Kiva,Escavada Black-on-white,10,1000,1100,100,1,1,1
3043,Beth's Great Kiva,Gallup Black-on-white,33,1040,1150,110,1,1,1
3043,Beth's Great Kiva,Kana-a Black-on-white,146,825,1000,175,1,1,1
3043,Beth's Great Kiva,Kiatuthlanna Black-on-white,123,850,925,75,1,1,1
3043,Beth's Great Kiva,La Plata Black-on-white,24,550,750,200,1,1,1
3043,Beth's Great Kiva,La Plata-White Mound Black-on-white,16,550,850,300,1,1,1
3043,Beth's Great Kiva,Lino Black-on-gray (Cibola),4,600,850,250,1,1,1
3043,Beth's Great Kiva,Lino Gray (Cibola),59,550,950,400,1,0,0
3043,Beth's Great Kiva,Medicine Black-on-red,6,1040,1170,130,1,1,1
3043,Beth's Great Kiva,"Mogollon Plain Brown Ware, Smudged",28,300,1400,1100,0,0,0
3043,Beth's Great Kiva,Pena Black-on-white,1,800,900,100,1,1,1
3043,Beth's Great Kiva,Puerco Black-on-red,1,1000,1175,175,1,1,1
3043,Beth's Great Kiva,Red Mesa Black-on-white,125,880,1040,160,1,1,1
3043,Beth's Great Kiva,"Red Ware type, Undifferentiated",15,700,1700,1000,0,0,0
3043,Beth's Great Kiva,Reserve Black-on-white,2,1050,1200,150,1,1,1
3043,Beth's Great Kiva,"San Juan Red ware, Undifferentiated",16,700,1050,350,0,0,1
3043,Beth's Great Kiva,Sanostee Black-on-red,23,825,875,50,1,1,1
3043,Beth's Great Kiva,St. Johns Polychrome,4,1200,1300,100,1,1,1
3043,Beth's Great Kiva,Tsegi Black-on-orange,1,1225,1300,75,1,1,1
3043,Beth's Great Kiva,"Tsegi Orange Ware, Undifferentiated",15,1000,1300,300,1,0,1
3043,Beth's Great Kiva,Tusayan Black-on-red,1,1045,1240,195,1,1,1
3043,Beth's Great Kiva,"Tusayan White Ware, Undifferentiated",70,825,1300,475,0,1,1
3043,Beth's Great Kiva,"Type, Undifferentiated",4,200,1900,1700,0,0,0
3043,Beth's Great Kiva,White Mound Black-on-white,4,700,850,150,1,1,1
3043,Beth's Great Kiva,"White Mountain type, Type Undifferentiated; Early",16,1000,1300,300,0,0,1
3043,Beth's Great Kiva,Wingate Polychrome,1,1100,1225,125,1,1,1
3044,Bis'saani East,Blue Shale Corrugated,800,925,1150,225,0,0,0
3044,Bis'saani East,Brimhall Black-on-white,11,1040,1150,110,1,1,1
3044,Bis'saani East,Cameron Polychrome,23,1040,1170,130,1,1,1
3044,Bis'saani East,Chaco Black-on-white,20,1075,1150,75,1,1,1
3044,Bis'saani East,Chaco-McElmo Black-on-white (carbon paint),388,1090,1175,85,1,1,1
3044,Bis'saani East,Chuska Black-on-white,20,1040,1125,85,1,1,1
3044,Bis'saani East,"Chuska Carbon Painted White Ware, Undifferentiated",17,800,1300,500,0,1,1
3044,Bis'saani East,"Chuska Plain Gray Ware, Type Undifferentiated",4,700,925,225,0,0,0
3044,Bis'saani East,"Chuska White Ware type, Undifferentiated",62,800,1300,500,0,1,1
3044,Bis'saani East,"Cibola PII/PIII Gray Ware, Type Undifferentiated",2216,950,1300,350,0,0,0
3044,Bis'saani East,Cibola Plain Gray,100,550,1040,490,0,0,0
3044,Bis'saani East,"Cibola White Ware, Undifferentiated",774,550,1325,775,0,1,1
3044,Bis'saani East,Citadel Polychrome,3,1040,1200,160,1,1,1
3044,Bis'saani East,"Corrugated Gray Ware, Undifferentiated",1854,800,1400,600,0,0,0
3044,Bis'saani East,Dogoszhi Black-on-white,2,1040,1210,170,1,1,1
3044,Bis'saani East,Escavada Black-on-white,206,1000,1100,100,1,1,1
3044,Bis'saani East,Gallup Black-on-white,130,1040,1150,110,1,1,1
3044,Bis'saani East,Mancos Black-on-white,327,980,1180,200,1,1,1
3044,Bis'saani East,Mancos Corrugated,4,920,1180,260,0,0,0
3044,Bis'saani East,McElmo Black-on-white,245,1060,1260,200,1,1,1
3044,Bis'saani East,Medicine Black-on-red,1,1040,1170,130,1,1,1
3044,Bis'saani East,Medicine/Tusayan Black-on-red,18,1040,1240,200,1,1,1
3044,Bis'saani East,"Mesa Verde Corrugated Gray Ware, Undifferentiated",2,920,1280,360,0,0,0
3044,Bis'saani East,"Mesa Verde White Ware, Undifferentiated",9,575,1280,705,0,1,1
3044,Bis'saani East,"Mogollon Brown ware, Undifferentiated",1,900,1400,500,0,0,0
3044,Bis'saani East,Mogollon Patterned Corrugated Brown Ware,28,1000,1400,400,0,0,0
3044,Bis'saani East,"Mogollon Plain Corrugated Brown Ware, Smudged",10,900,1400,500,0,0,0
3044,Bis'saani East,Nava Black-on-white,44,1100,1275,175,1,1,1
3044,Bis'saani East,Piedra Black-on-white,2,800,920,120,1,1,1
3044,Bis'saani East,"PII/PIII White Ware, Type Undifferentiated",5,900,1300,400,0,1,1
3044,Bis'saani East,Pitoche Plain,2,500,1000,500,0,0,0
3044,Bis'saani East,"Plain Gray Ware, Undifferentiated",15,500,1300,800,0,0,0
3044,Bis'saani East,Puerco Black-on-red,79,1000,1175,175,1,1,1
3044,Bis'saani East,Puerco Black-on-white,75,1030,1200,170,1,1,1
3044,Bis'saani East,Reserve Black-on-white,8,1050,1200,150,1,1,1
3044,Bis'saani East,Showlow Red,15,1000,1100,100,0,1,0
3044,Bis'saani East,Socorro Black-on-white,136,1050,1300,250,1,1,1
3044,Bis'saani East,Sosi Black-on-white,38,1070,1180,110,1,1,1
3044,Bis'saani East,Toadlena Black-on-white,12,975,1125,150,1,1,1
3044,Bis'saani East,"Tsegi Orange Ware, Undifferentiated",39,1000,1300,300,1,0,1
3044,Bis'saani East,Tusayan Black-on-red,20,1045,1240,195,1,1,1
3044,Bis'saani East,Tusayan Polychrome,6,1110,1320,210,1,1,1
3044,Bis'saani East,"Type, Undifferentiated",14,200,1900,1700,0,0,0
3044,Bis'saani East,"White Mountain type, Type Undifferentiated; Early",37,1000,1300,300,0,0,1
3044,Bis'saani East,"White ware, Undifferentiated",5,550,1900,1350,0,0,1
3044,Bis'saani East,Wingate Black-on-red,49,1050,1225,175,1,1,1
3044,Bis'saani East,Woodruff Smudged,16,500,1100,600,0,0,0
3045,Bis'saani West,Blue Shale Corrugated,20,925,1150,225,0,0,0
3045,Bis'saani West,Chaco-McElmo Black-on-white (carbon paint),66,1090,1175,85,1,1,1
3045,Bis'saani West,"Chuska White Ware type, Undifferentiated",2,800,1300,500,0,1,1
3045,Bis'saani West,"Cibola PII/PIII Gray Ware, Type Undifferentiated",295,950,1300,350,0,0,0
3045,Bis'saani West,Cibola Plain Gray,16,550,1040,490,0,0,0
3045,Bis'saani West,"Cibola White Ware, Undifferentiated",155,550,1325,775,0,1,1
3045,Bis'saani West,"Corrugated Gray Ware, Undifferentiated",128,800,1400,600,0,0,0
3045,Bis'saani West,Escavada Black-on-white,9,1000,1100,100,1,1,1
3045,Bis'saani West,Gallup Black-on-white,18,1040,1150,110,1,1,1
3045,Bis'saani West,Mancos Black-on-white,9,980,1180,200,1,1,1
3045,Bis'saani West,Mancos Corrugated,6,920,1180,260,0,0,0
3045,Bis'saani West,McElmo Black-on-white,8,1060,1260,200,1,1,1
3045,Bis'saani West,Nava Black-on-white,9,1100,1275,175,1,1,1
3045,Bis'saani West,"Plain Gray Ware, Undifferentiated",3,500,1300,800,0,0,0
3045,Bis'saani West,Puerco Black-on-red,5,1000,1175,175,1,1,1
3045,Bis'saani West,Puerco Black-on-white,4,1030,1200,170,1,1,1
3045,Bis'saani West,Socorro Black-on-white,2,1050,1300,250,1,1,1
3045,Bis'saani West,"White Mountain type, Type Undifferentiated; Early",3,1000,1300,300,0,0,1
3046,Black Creek Flat,"Chuska PII/PIII Black-on-white, Type Undifferentiated",1,900,1300,400,0,1,1
3046,Black Creek Flat,Cibola Clapboard Corrugated Gray,1,900,1100,200,0,1,0
3046,Black Creek Flat,Cibola Indented Corrugated Gray,7,1040,1400,360,0,0,0
3046,Black Creek Flat,"Cibola PII/PIII White Ware, Type Undifferentiated",8,1000,1300,300,1,1,1
3046,Black Creek Flat,Cortez Black-on-white,1,880,1060,180,1,1,1
3046,Black Creek Flat,Escavada Black-on-white,2,1000,1100,100,1,1,1
3046,Black Creek Flat,Gallup Black-on-white,4,1040,1150,110,1,1,1
3046,Black Creek Flat,McElmo Black-on-white,1,1060,1260,200,1,1,1
3046,Black Creek Flat,Red Mesa Black-on-white,2,880,1040,160,1,1,1
3046,Black Creek Flat,Sosi Black-on-white,1,1070,1180,110,1,1,1
3046,Black Creek Flat,"White Mountain type, Type Undifferentiated; Early",1,1000,1300,300,0,0,1
3046,Black Creek Flat,Wingate Polychrome,2,1100,1225,125,1,1,1
3047,Black Mesa Ruin,Abajo Red-on-orange,4,760,880,120,1,1,1
3047,Black Mesa Ruin,Black Mesa/Sosi Black-on-white,1,1000,1180,180,1,1,1
3047,Black Mesa Ruin,Bluff Black-on-red,92,800,925,125,1,1,1
3047,Black Mesa Ruin,Cameron Polychrome,2,1040,1170,130,1,1,1
3047,Black Mesa Ruin,Chapin Black-on-white,1,575,880,305,0,1,1
3047,Black Mesa Ruin,Citadel Polychrome,3,1040,1200,160,1,1,1
3047,Black Mesa Ruin,"Corrugated Gray Ware, Undifferentiated",1,800,1400,600,0,0,0
3047,Black Mesa Ruin,Deadmans (La Plata) Black-on-red,4,880,1050,170,1,1,1
3047,Black Mesa Ruin,Lino Gray (Tusayan),4,550,950,400,0,0,0
3047,Black Mesa Ruin,Mancos Black-on-white,48,980,1180,200,1,1,1
3047,Black Mesa Ruin,McElmo Black-on-white,20,1060,1260,200,1,1,1
3047,Black Mesa Ruin,"Mesa Verde Corrugated Gray Ware, Undifferentiated",45,920,1280,360,0,0,0
3047,Black Mesa Ruin,Mesa Verde Neckbanded Gray,60,800,1060,260,0,0,0
3047,Black Mesa Ruin,"Mesa Verde PII/PIII White Ware, Type Undifferentiated",9,920,1280,360,0,1,1
3047,Black Mesa Ruin,"Narrow Neckbanded Gray Ware, Type Undifferentiated",46,900,1025,125,0,1,0
3047,Black Mesa Ruin,"Neckbanded Gray Ware, Undifferentiated",109,850,1025,175,0,1,0
3047,Black Mesa Ruin,"Plain Gray Ware, Undifferentiated",131,500,1300,800,0,0,0
3047,Black Mesa Ruin,"San Juan Red ware, Undifferentiated",57,700,1050,350,0,0,1
3047,Black Mesa Ruin,"Tsegi Orange Ware, Undifferentiated",15,1000,1300,300,1,0,1
3047,Black Mesa Ruin,Tusayan Black-on-red,6,1045,1240,195,1,1,1
3047,Black Mesa Ruin,Tusayan Polychrome,3,1110,1320,210,1,1,1
3047,Black Mesa Ruin,Wetherill Black-on-white,6,1060,1180,120,1,1,1
3047,Black Mesa Ruin,White Mesa Black-on-white,32,850,1000,150,1,1,1
3047,Black Mesa Ruin,"White ware, Undifferentiated",37,550,1900,1350,0,0,1
3048,Blackrock Gaddy,Black Mesa Black-on-white,2,1000,1100,100,1,1,1
3048,Blackrock Gaddy,Chaco Black-on-white,2,1075,1150,75,1,1,1
3048,Blackrock Gaddy,Escavada Black-on-white,30,1000,1100,100,1,1,1
3048,Blackrock Gaddy,Gallup Black-on-white,30,1040,1150,110,1,1,1
3048,Blackrock Gaddy,Holbrook A Black-on-white,2,1050,1150,100,1,1,1
3048,Blackrock Gaddy,Holbrook B Black-on-white,78,1050,1150,100,1,1,1
3048,Blackrock Gaddy,Jeddito Black-on-orange,12,1250,1300,50,1,1,1
3048,Blackrock Gaddy,Jeddito Polychrome,2,1250,1300,50,1,1,1
3048,Blackrock Gaddy,Kayenta Black-on-white,4,1250,1300,50,1,1,1
3048,Blackrock Gaddy,Klagetoh Black-on-white,16,1250,1300,50,1,1,1
3048,Blackrock Gaddy,Klagetoh Black-on-yellow,2,1250,1300,50,1,1,1
3048,Blackrock Gaddy,Leupp Black-on-white,10,1200,1250,50,1,1,1
3048,Blackrock Gaddy,Puerco Black-on-red,12,1000,1175,175,1,1,1
3048,Blackrock Gaddy,Puerco Black-on-white,8,1030,1200,170,1,1,1
3048,Blackrock Gaddy,Reserve Black-on-white,20,1050,1200,150,1,1,1
3048,Blackrock Gaddy,Showlow Black-on-red,22,1030,1200,170,1,1,1
3048,Blackrock Gaddy,Showlow Red,12,1000,1100,100,0,1,0
3048,Blackrock Gaddy,St. Johns Polychrome,14,1200,1300,100,1,1,1
3048,Blackrock Gaddy,Tularosa Black-on-white,10,1180,1300,120,1,1,1
3048,Blackrock Gaddy,Tusayan Black-on-white,14,1200,1300,100,1,1,1
3048,Blackrock Gaddy,Tusayan Polychrome,2,1110,1320,210,1,1,1
3048,Blackrock Gaddy,Walnut Black-on-white,4,1100,1250,150,1,1,1
3048,Blackrock Gaddy,"White ware, Undifferentiated",10,550,1900,1350,0,0,1
3048,Blackrock Gaddy,Wingate Black-on-red,6,1050,1225,175,1,1,1
3048,Blackrock Gaddy,Wingate Polychrome,6,1100,1225,125,1,1,1
3049,Blue J,Chaco Black-on-white,2,1075,1150,75,1,1,1
3049,Blue J,Chaco-McElmo Black-on-white (carbon paint),2,1090,1175,85,1,1,1
3049,Blue J,Cibola Indented Corrugated Gray,34,1040,1400,360,0,0,0
3049,Blue J,Cibola Neckbanded Gray,5,850,1025,175,0,1,0
3049,Blue J,Cibola Plain Gray,1,550,1040,490,0,0,0
3049,Blue J,"Cibola White Ware, Undifferentiated",10,550,1325,775,0,1,1
3049,Blue J,Cortez Black-on-white,1,880,1060,180,1,1,1
3049,Blue J,Escavada Black-on-white,101,1000,1100,100,1,1,1
3049,Blue J,Gallup Black-on-white,225,1040,1150,110,1,1,1
3049,Blue J,Holbrook Black-on-white,3,1050,1150,100,1,1,1
3049,Blue J,Kiatuthlanna Black-on-white,49,850,925,75,1,1,1
3049,Blue J,Mancos Black-on-white,3,980,1180,200,1,1,1
3049,Blue J,McElmo Black-on-white,2,1060,1260,200,1,1,1
3049,Blue J,Padre Black-on-white,1,1100,1250,150,1,1,1
3049,Blue J,Puerco Black-on-red,17,1000,1175,175,1,1,1
3049,Blue J,Puerco Black-on-white,19,1030,1200,170,1,1,1
3049,Blue J,Red Mesa Black-on-white,13,880,1040,160,1,1,1
3049,Blue J,Reserve Black-on-white,17,1050,1200,150,1,1,1
3049,Blue J,White Mound Black-on-white,23,700,850,150,1,1,1
3049,Blue J,Wingate Black-on-red,6,1050,1225,175,1,1,1
3050,Blue Mesa,Abajo Red-on-orange,6,760,880,120,1,1,1
3050,Blue Mesa,Arboles Gray,18,900,1050,150,0,1,0
3050,Blue Mesa,Bluff Black-on-red,64,800,925,125,1,1,1
3050,Blue Mesa,"BMIII/PI White Ware, Type Undifferentiated",7,550,900,350,0,1,1
3050,Blue Mesa,"Brown Ware, Undifferentiated",35,500,1450,950,0,0,0
3050,Blue Mesa,Chapin Black-on-white,4,575,880,305,0,1,1
3050,Blue Mesa,"Corrugated Gray Ware, Undifferentiated",2,800,1400,600,0,0,0
3050,Blue Mesa,"Mudware, Undifferentiated",2,400,1400,1000,0,0,0
3050,Blue Mesa,"Neckbanded Gray Ware, Undifferentiated",3,850,1025,175,0,1,0
3050,Blue Mesa,Rosa Black-on-white,160,700,875,175,1,1,1
3050,Blue Mesa,Rosa Gray,584,700,1000,300,0,0,0
3050,Blue Mesa,Rosa Neckbanded,4,775,900,125,0,1,0
3050,Blue Mesa,"San Juan Red ware, Undifferentiated",55,700,1050,350,0,0,1
3050,Blue Mesa,Upper San Juan PI Gray Ware,8838,700,900,200,0,1,0
3050,Blue Mesa,"White ware, Undifferentiated",638,550,1900,1350,0,0,1
3051,Bluewater Spring,Captain Tom Corrugated,1,890,1000,110,0,1,0
3051,Bluewater Spring,Cebolleta Black-on-white,5,1000,1200,200,1,1,1
3051,Bluewater Spring,"Chuska Plain Gray Ware, Type Undifferentiated",15,700,925,225,0,0,0
3051,Bluewater Spring,"Cibola Black-on-white, Undifferentiated",545,550,1325,775,0,1,1
3051,Bluewater Spring,Cibola Clapboard Corrugated Gray,3,900,1100,200,0,1,0
3051,Bluewater Spring,"Cibola Corrugated Gray Ware, Undifferentiated",1,900,1400,500,0,0,0
3051,Bluewater Spring,Cibola Indented Corrugated Gray,107,1040,1400,360,0,0,0
3051,Bluewater Spring,Cibola Narrow Neckbanded,12,900,1025,125,0,1,0
3051,Bluewater Spring,Cibola Neckbanded Gray,1,850,1025,175,0,1,0
3051,Bluewater Spring,"Cibola PII Gray Ware, Type Undifferentiated",5,950,1100,150,0,1,0
3051,Bluewater Spring,"Cibola PII/PIII White Ware, Type Undifferentiated",28,1000,1300,300,1,1,1
3051,Bluewater Spring,"Cibola White Ware, Undifferentiated",9,550,1325,775,0,1,1
3051,Bluewater Spring,Cibola Wide Neckbanded,796,850,925,75,0,1,0
3051,Bluewater Spring,Coolidge Corrugated,2335,1050,1100,50,0,1,0
3051,Bluewater Spring,Escavada Black-on-white,8,1000,1100,100,1,1,1
3051,Bluewater Spring,Gallup Black-on-white,622,1040,1150,110,1,1,1
3051,Bluewater Spring,Kiatuthlanna Black-on-white,10,850,925,75,1,1,1
3051,Bluewater Spring,Kiatuthlanna-Red Mesa Black-on-white,4,850,1040,190,1,1,1
3051,Bluewater Spring,"Plain Gray Ware, Undifferentiated",2077,500,1300,800,0,0,0
3051,Bluewater Spring,Puerco Black-on-red,1,1000,1175,175,1,1,1
3051,Bluewater Spring,Puerco Black-on-white,445,1030,1200,170,1,1,1
3051,Bluewater Spring,Red Mesa Black-on-white,131,880,1040,160,1,1,1
3051,Bluewater Spring,"Red Ware type, Undifferentiated",1,700,1700,1000,0,0,0
3051,Bluewater Spring,Reserve Black-on-white,1,1050,1200,150,1,1,1
3051,Bluewater Spring,Socorro Black-on-white,4,1050,1300,250,1,1,1
3051,Bluewater Spring,"White ware, Undifferentiated",1,550,1900,1350,0,0,1
3051,Bluewater Spring,Woodruff Smudged,13,500,1100,600,0,0,0
3052,Bluff Great House,Abajo Red-on-orange,1,760,880,120,1,1,1
3052,Bluff Great House,Adamana Brown,2,300,550,250,0,0,0
3052,Bluff Great House,Black Mesa Black-on-white,92,1000,1100,100,1,1,1
3052,Bluff Great House,Blue Shale Corrugated,2,925,1150,225,0,0,0
3052,Bluff Great House,Bluff Black-on-red,152,800,925,125,1,1,1
3052,Bluff Great House,Brimhall Black-on-white,1,1040,1150,110,1,1,1
3052,Bluff Great House,Cameron Polychrome,45,1040,1170,130,1,1,1
3052,Bluff Great House,Captain Tom Corrugated,11,890,1000,110,0,1,0
3052,Bluff Great House,Chaco Black-on-white,13,1075,1150,75,1,1,1
3052,Bluff Great House,Chapin Black-on-white,8,575,880,305,0,1,1
3052,Bluff Great House,Chapin Gray,57,575,980,405,0,0,0
3052,Bluff Great House,Chuska Black-on-white,1,1040,1125,85,1,1,1
3052,Bluff Great House,"Chuska Corrugated Gray Ware, Undifferentiated",28,890,1300,410,0,0,0
3052,Bluff Great House,"Chuska Gray Ware, Type Undifferentiated",2,700,1300,600,0,0,0
3052,Bluff Great House,"Chuska PII/PIII Black-on-white, Type Undifferentiated",5,900,1300,400,0,1,1
3052,Bluff Great House,"Chuska Plain Gray Ware, Type Undifferentiated",34,700,925,225,0,0,0
3052,Bluff Great House,"Chuska White Ware type, Undifferentiated",6,800,1300,500,0,1,1
3052,Bluff Great House,"Cibola Black-on-white, Undifferentiated",10,550,1325,775,0,1,1
3052,Bluff Great House,"Cibola Corrugated Gray Ware, Undifferentiated",6,900,1400,500,0,0,0
3052,Bluff Great House,"Cibola PII/PIII White Ware, Type Undifferentiated",1,1000,1300,300,1,1,1
3052,Bluff Great House,"Cibola White Ware, Undifferentiated",1,550,1325,775,0,1,1
3052,Bluff Great House,Citadel Polychrome,20,1040,1200,160,1,1,1
3052,Bluff Great House,Coconino Gray,7,950,1100,150,0,1,0
3052,Bluff Great House,"Corrugated Gray Ware, Undifferentiated",1,800,1400,600,0,0,0
3052,Bluff Great House,Cortez Black-on-white,4,880,1060,180,1,1,1
3052,Bluff Great House,Deadmans (La Plata) Black-on-red,759,880,1050,170,1,1,1
3052,Bluff Great House,Dogoszhi Black-on-white,93,1040,1210,170,1,1,1
3052,Bluff Great House,Dolores Corrugated,167,1100,1200,100,0,1,0
3052,Bluff Great House,Escavada Black-on-white,3,1000,1100,100,1,1,1
3052,Bluff Great House,Flagstaff Black-on-white,14,1150,1220,70,1,1,1
3052,Bluff Great House,Gallup Black-on-white,4,1040,1150,110,1,1,1
3052,Bluff Great House,Gray Hills Banded,11,850,950,100,0,1,0
3052,Bluff Great House,Hunter Corrugated,4,1100,1300,200,0,1,0
3052,Bluff Great House,Kana-a Black-on-white,36,825,1000,175,1,1,1
3052,Bluff Great House,Kana'a Gray Ware,9,865,1060,195,0,1,0
3052,Bluff Great House,Lino Gray (Tusayan),18,550,950,400,0,0,0
3052,Bluff Great House,Mancos Black-on-white,819,980,1180,200,1,1,1
3052,Bluff Great House,Mancos Corrugated,124,920,1180,260,0,0,0
3052,Bluff Great House,Mancos Gray,732,880,1060,180,0,1,0
3052,Bluff Great House,McElmo Black-on-white,156,1060,1260,200,1,1,1
3052,Bluff Great House,McPhee Black-on-red,9,800,925,125,1,1,1
3052,Bluff Great House,Medicine Black-on-red,43,1040,1170,130,1,1,1
3052,Bluff Great House,Mesa Verde Black-on-white,145,1180,1280,100,1,1,1
3052,Bluff Great House,"Mesa Verde BMIII/PI White Ware, Type Undifferentiated",19,575,920,345,0,1,1
3052,Bluff Great House,Mesa Verde Corrugated,90,1100,1280,180,0,1,0
3052,Bluff Great House,"Mesa Verde Corrugated Gray Ware, Undifferentiated",7115,920,1280,360,0,0,0
3052,Bluff Great House,"Mesa Verde Gray ware, Undifferentiated",13,575,1280,705,0,0,0
3052,Bluff Great House,Mesa Verde Neck Corrugated Gray,23,950,1025,75,0,1,0
3052,Bluff Great House,"Mesa Verde PII/PIII White Ware, Type Undifferentiated",1137,920,1280,360,0,1,1
3052,Bluff Great House,"Mesa Verde PIII White Ware, Type Undifferentiated",328,1100,1280,180,1,1,1
3052,Bluff Great House,Mesa Verde Plain Gray,2783,575,1020,445,0,0,0
3052,Bluff Great House,"Mesa Verde White Ware, Undifferentiated",2281,575,1280,705,0,1,1
3052,Bluff Great House,Moccasin Gray,86,800,980,180,0,1,0
3052,Bluff Great House,"Mogollon Brown ware, Undifferentiated",8,900,1400,500,0,0,0
3052,Bluff Great House,"Mogollon Corrugated Brown Ware, Undifferentiated",2,800,1400,600,0,0,0
3052,Bluff Great House,Naschitti Black-on-white,1,900,1000,100,1,1,1
3052,Bluff Great House,Nava Black-on-white,2,1100,1275,175,1,1,1
3052,Bluff Great House,Newcomb Black-on-white,3,875,1000,125,1,1,1
3052,Bluff Great House,Obelisk Gray,13,400,700,300,0,0,0
3052,Bluff Great House,Piedra Black-on-white,1,800,920,120,1,1,1
3052,Bluff Great House,Puerco Black-on-red,5,1000,1175,175,1,1,1
3052,Bluff Great House,Puerco Black-on-white,1,1030,1200,170,1,1,1
3052,Bluff Great House,Red Mesa Black-on-white,3,880,1040,160,1,1,1
3052,Bluff Great House,"Red Ware type, Undifferentiated",2,700,1700,1000,0,0,0
3052,Bluff Great House,"Sambrito Utility Ware, Undifferentiated",17,300,700,400,0,0,0
3052,Bluff Great House,"San Juan Red ware, Undifferentiated",668,700,1050,350,0,0,1
3052,Bluff Great House,Sheep Springs Gray,1,800,850,50,0,1,0
3052,Bluff Great House,Sosi Black-on-white,174,1070,1180,110,1,1,1
3052,Bluff Great House,Tallohogan Red,3,620,875,255,0,0,0
3052,Bluff Great House,Toadlena Black-on-white,7,975,1125,150,1,1,1
3052,Bluff Great House,Tocito Gray,3,825,875,50,0,1,0
3052,Bluff Great House,"Tsegi Orange Ware, Undifferentiated",353,1000,1300,300,1,0,1
3052,Bluff Great House,Tusayan Black-on-red,424,1045,1240,195,1,1,1
3052,Bluff Great House,"Tusayan Corrugated Gray Ware, Undifferentiated",1938,865,1285,420,0,0,0
3052,Bluff Great House,"Tusayan Gray Ware, Undifferentiated",6,550,1285,735,0,0,0
3052,Bluff Great House,"Tusayan PI/PII White Ware, Type Undifferentiated",6,800,1100,300,1,1,1
3052,Bluff Great House,"Tusayan PII/PIII White Ware, Type Undifferentiated",236,900,1300,400,0,1,1
3052,Bluff Great House,Tusayan Plain Gray,512,600,1300,700,0,0,0
3052,Bluff Great House,Tusayan Polychrome,34,1110,1320,210,1,1,1
3052,Bluff Great House,"Tusayan White Ware, Undifferentiated",459,825,1300,475,0,1,1
3052,Bluff Great House,"Type, Undifferentiated",29,200,1900,1700,0,0,0
3052,Bluff Great House,White Mesa Black-on-white,72,850,1000,150,1,1,1
3052,Bluff Great House,"White Mountain type, Type Undifferentiated; Early",4,1000,1300,300,0,0,1
3052,Bluff Great House,"White ware, Undifferentiated",3,550,1900,1350,0,0,1
3052,Bluff Great House,Wingate Black-on-red,3,1050,1225,175,1,1,1
3052,Bluff Great House,Wingate Polychrome,3,1100,1225,125,1,1,1
3053,Bluff Bench Great Kiva,Bluff Black-on-red,20,800,925,125,1,1,1
3053,Bluff Bench Great Kiva,Mancos Gray,101,880,1060,180,0,1,0
3053,Bluff Bench Great Kiva,Mesa Verde Plain Gray,500,575,1020,445,0,0,0
3053,Bluff Bench Great Kiva,Moccasin Gray,30,800,980,180,0,1,0
3053,Bluff Bench Great Kiva,"PI White Ware, Type Undifferentiated",10,700,900,200,1,1,1
3053,Bluff Bench Great Kiva,Piedra Black-on-white,1,800,920,120,1,1,1
3053,Bluff Bench Great Kiva,"San Juan Red ware, Undifferentiated",50,700,1050,350,0,0,1
3056,Carhart Ruin,Chapin Gray,1,575,980,405,0,0,0
3056,Carhart Ruin,Cortez Black-on-white,6,880,1060,180,1,1,1
3056,Carhart Ruin,Mancos Black-on-white,152,980,1180,200,1,1,1
3056,Carhart Ruin,Mancos Corrugated,24,920,1180,260,0,0,0
3056,Carhart Ruin,McElmo Black-on-white,36,1060,1260,200,1,1,1
3056,Carhart Ruin,Mesa Verde Black-on-white,20,1180,1280,100,1,1,1
3056,Carhart Ruin,Mesa Verde Corrugated,3,1100,1280,180,0,1,0
3056,Carhart Ruin,"Mesa Verde Corrugated Gray Ware, Undifferentiated",920,920,1280,360,0,0,0
3056,Carhart Ruin,"Mesa Verde Gray ware, Undifferentiated",165,575,1280,705,0,0,0
3056,Carhart Ruin,"Mesa Verde PI/PII White Ware, Type Undifferentiated",19,750,1180,430,0,1,1
3056,Carhart Ruin,"Mesa Verde PII White Ware, Type Undifferentiated",36,920,1100,180,1,1,1
3056,Carhart Ruin,"Mesa Verde PII/PIII White Ware, Type Undifferentiated",708,920,1280,360,0,1,1
3056,Carhart Ruin,"Mesa Verde PIII White Ware, Type Undifferentiated",69,1100,1280,180,1,1,1
3056,Carhart Ruin,Piedra Black-on-white,3,800,920,120,1,1,1
3056,Carhart Ruin,"San Juan Red ware, Undifferentiated",7,700,1050,350,0,0,1
3056,Carhart Ruin,"Type, Undifferentiated",11,200,1900,1700,0,0,0
3057,Carol's Ruin,Chapin Gray,2,575,980,405,0,0,0
3057,Carol's Ruin,Cortez Black-on-white,1,880,1060,180,1,1,1
3057,Carol's Ruin,Deadmans (La Plata) Black-on-red,11,880,1050,170,1,1,1
3057,Carol's Ruin,Dolores Corrugated,1,1100,1200,100,0,1,0
3057,Carol's Ruin,Mancos Black-on-white,3,980,1180,200,1,1,1
3057,Carol's Ruin,Mancos Corrugated,6,920,1180,260,0,0,0
3057,Carol's Ruin,Mancos Gray,28,880,1060,180,0,1,0
3057,Carol's Ruin,"Mesa Verde BMIII/PI White Ware, Type Undifferentiated",50,575,920,345,0,1,1
3057,Carol's Ruin,"Mesa Verde Corrugated Gray Ware, Undifferentiated",89,920,1280,360,0,0,0
3057,Carol's Ruin,"Mesa Verde PII White Ware, Type Undifferentiated",14,920,1100,180,1,1,1
3057,Carol's Ruin,"Mesa Verde PII/PIII White Ware, Type Undifferentiated",27,920,1280,360,0,1,1
3057,Carol's Ruin,"Mesa Verde PIII White Ware, Type Undifferentiated",2,1100,1280,180,1,1,1
3057,Carol's Ruin,Mesa Verde Plain Gray,237,575,1020,445,0,0,0
3057,Carol's Ruin,Moccasin Gray,43,800,980,180,0,1,0
3057,Carol's Ruin,Piedra Black-on-white,3,800,920,120,1,1,1
3057,Carol's Ruin,"San Juan Red ware, Undifferentiated",5,700,1050,350,0,0,1
3059,Casa Abajo,Bennett Gray,48,700,850,150,0,1,0
3059,Casa Abajo,Blue Shale Corrugated,2,925,1150,225,0,0,0
3059,Casa Abajo,Chaco-McElmo Black-on-white (carbon paint),3,1090,1175,85,1,1,1
3059,Casa Abajo,"Chuska Clapboard Corrugated Gray, Undifferentiated",2,900,1100,200,0,1,0
3059,Casa Abajo,"Chuska Gray Ware, Type Undifferentiated",1,700,1300,600,0,0,0
3059,Casa Abajo,Chuska Indented Corrugated Gray,23,1040,1300,260,0,0,0
3059,Casa Abajo,Chuska Neckbanded,1,800,950,150,0,1,0
3059,Casa Abajo,"Chuska Plain Gray Ware, Type Undifferentiated",17,700,925,225,0,0,0
3059,Casa Abajo,"Chuska White Ware type, Undifferentiated",8,800,1300,500,0,1,1
3059,Casa Abajo,"Cibola Black-on-white, Undifferentiated",86,550,1325,775,0,1,1
3059,Casa Abajo,Cibola Clapboard Corrugated Gray,4,900,1100,200,0,1,0
3059,Casa Abajo,"Cibola Corrugated Gray Ware, Undifferentiated",56,900,1400,500,0,0,0
3059,Casa Abajo,Cibola Indented Corrugated Gray,48,1040,1400,360,0,0,0
3059,Casa Abajo,Cibola Neckbanded Gray,45,850,1025,175,0,1,0
3059,Casa Abajo,Cibola Plain Gray,262,550,1040,490,0,0,0
3059,Casa Abajo,"Cibola White Ware, Undifferentiated",118,550,1325,775,0,1,1
3059,Casa Abajo,Escavada Black-on-white,18,1000,1100,100,1,1,1
3059,Casa Abajo,Escavada-Puerco Black-on-white,13,1000,1100,100,1,1,1
3059,Casa Abajo,Gallup Black-on-white,8,1040,1150,110,1,1,1
3059,Casa Abajo,La Plata Black-on-white,16,550,750,200,1,1,1
3059,Casa Abajo,Pena Black-on-white,6,800,900,100,1,1,1
3059,Casa Abajo,Puerco Black-on-red,2,1000,1175,175,1,1,1
3059,Casa Abajo,Red Mesa Black-on-white,71,880,1040,160,1,1,1
3059,Casa Abajo,Sheep Springs Gray,2,800,850,50,0,1,0
3059,Casa Abajo,Sosi Black-on-white,2,1070,1180,110,1,1,1
3059,Casa Abajo,White Mound Black-on-white,1,700,850,150,1,1,1
3059,Casa Abajo,"White Mountain type, Type Undifferentiated; Early",12,1000,1300,300,0,0,1
3059,Casa Abajo,Wingate Black-on-red,2,1050,1225,175,1,1,1
3061,Casa Cielo,Bennett Gray,1,700,850,150,0,1,0
3061,Casa Cielo,Chaco Black-on-white,2,1075,1150,75,1,1,1
3061,Casa Cielo,Chaco-McElmo Black-on-white (carbon paint),26,1090,1175,85,1,1,1
3061,Casa Cielo,Chuska Indented Corrugated Gray,40,1040,1300,260,0,0,0
3061,Casa Cielo,"Cibola Black-on-white, Undifferentiated",63,550,1325,775,0,1,1
3061,Casa Cielo,Cibola Indented Corrugated Gray,282,1040,1400,360,0,0,0
3061,Casa Cielo,Cibola Plain Gray,7,550,1040,490,0,0,0
3061,Casa Cielo,"Cibola White Ware, Undifferentiated",59,550,1325,775,0,1,1
3061,Casa Cielo,Escavada Black-on-white,15,1000,1100,100,1,1,1
3061,Casa Cielo,Escavada-Puerco Black-on-white,31,1000,1100,100,1,1,1
3061,Casa Cielo,Gallup Black-on-white,31,1040,1150,110,1,1,1
3061,Casa Cielo,Puerco Black-on-red,5,1000,1175,175,1,1,1
3061,Casa Cielo,Red Mesa Black-on-white,2,880,1040,160,1,1,1
3061,Casa Cielo,"San Juan Red ware, Undifferentiated",1,700,1050,350,0,0,1
3061,Casa Cielo,"White Mountain type, Type Undifferentiated; Early",2,1000,1300,300,0,0,1
3062,Casa del Rio,Abajo Red-on-orange,1,760,880,120,1,1,1
3062,Casa del Rio,Black Mesa Black-on-white,1,1000,1100,100,1,1,1
3062,Casa del Rio,Bluff Black-on-red,3,800,925,125,1,1,1
3062,Casa del Rio,"BMIII/PI White Ware, Type Undifferentiated",1,550,900,350,0,1,1
3062,Casa del Rio,Brimhall Black-on-white,1,1040,1150,110,1,1,1
3062,Casa del Rio,Burnham Black-on-white,3,860,1000,140,1,1,1
3062,Casa del Rio,Chaco Black-on-white,3,1075,1150,75,1,1,1
3062,Casa del Rio,Chaco-McElmo Black-on-white (carbon paint),11,1090,1175,85,1,1,1
3062,Casa del Rio,Chuska Black-on-white,10,1040,1125,85,1,1,1
3062,Casa del Rio,"Chuska Carbon Painted White Ware, Undifferentiated",53,800,1300,500,0,1,1
3062,Casa del Rio,"Chuska Gray Ware, Type Undifferentiated",45,700,1300,600,0,0,0
3062,Casa del Rio,Chuska Indented Corrugated Gray,368,1040,1300,260,0,0,0
3062,Casa del Rio,"Chuska Mineral Painted White Ware, Undifferentiated",9,800,1300,500,0,1,1
3062,Casa del Rio,Chuska Neck Indented Corrugated Gray,33,950,1025,75,0,1,0
3062,Casa del Rio,"Chuska PII Gray, Type Undifferentiated",10,1040,1100,60,0,1,0
3062,Casa del Rio,"Chuska PIII Gray, Type Undifferentiated",3,1100,1300,200,0,1,0
3062,Casa del Rio,"Chuska Plain Gray Ware, Type Undifferentiated",371,700,925,225,0,0,0
3062,Casa del Rio,"Chuska White Ware type, Undifferentiated",143,800,1300,500,0,1,1
3062,Casa del Rio,"Cibola Black-on-white, Undifferentiated",25,550,1325,775,0,1,1
3062,Casa del Rio,"Cibola BMIII/PI White Ware, Type Undifferentiated",67,550,900,350,0,1,1
3062,Casa del Rio,"Cibola Gray Ware, Undifferentiated",49,550,1400,850,0,0,0
3062,Casa del Rio,Cibola Indented Corrugated Gray,200,1040,1400,360,0,0,0
3062,Casa del Rio,Cibola Narrow Neckbanded,144,900,1025,125,0,1,0
3062,Casa del Rio,Cibola Neck Indented Corrugated,5,950,1025,75,0,1,0
3062,Casa del Rio,Cibola Neckbanded Gray,3,850,1025,175,0,1,0
3062,Casa del Rio,"Cibola PII Gray Ware, Type Undifferentiated",4,950,1100,150,0,1,0
3062,Casa del Rio,"Cibola PII/PIII Gray Ware, Type Undifferentiated",1,950,1300,350,0,0,0
3062,Casa del Rio,Cibola Plain Gray,981,550,1040,490,0,0,0
3062,Casa del Rio,Cibola Wide Neckbanded,54,850,925,75,0,1,0
3062,Casa del Rio,Crozier Black-on-white,3,800,900,100,1,1,1
3062,Casa del Rio,Drolet Black-on-white,12,900,1000,100,1,1,1
3062,Casa del Rio,Escavada-Puerco Black-on-white,4,1000,1100,100,1,1,1
3062,Casa del Rio,Gallup Black-on-white,151,1040,1150,110,1,1,1
3062,Casa del Rio,Gray Hills Banded,169,850,950,100,0,1,0
3062,Casa del Rio,"Indented Corrugated Gray Ware, Undifferentiated",1,950,1400,450,0,0,0
3062,Casa del Rio,Kana-a Black-on-white,19,825,1000,175,1,1,1
3062,Casa del Rio,Kiatuthlanna Black-on-white,303,850,925,75,1,1,1
3062,Casa del Rio,Kiatuthlanna-Red Mesa Black-on-white,18,850,1040,190,1,1,1
3062,Casa del Rio,La Plata Black-on-white,13,550,750,200,1,1,1
3062,Casa del Rio,Lino Black-on-gray (Cibola),4,600,850,250,1,1,1
3062,Casa del Rio,Lino Gray (Cibola),24,550,950,400,1,0,0
3062,Casa del Rio,Lino Gray (trachyte),2,550,950,400,0,0,0
3062,Casa del Rio,Lino Gray Fugitive Red [Cibola Series],1,550,850,300,1,0,0
3062,Casa del Rio,Mancos Black-on-white,1,980,1180,200,1,1,1
3062,Casa del Rio,Naschitti Black-on-white,7,900,1000,100,1,1,1
3062,Casa del Rio,Newcomb Black-on-white,31,875,1000,125,1,1,1
3062,Casa del Rio,Newcomb or Burnham Black-on-white,1,860,1000,140,1,1,1
3062,Casa del Rio,Pena Black-on-white,14,800,900,100,1,1,1
3062,Casa del Rio,"PI/PII White Ware, Type Undifferentiated",17,700,1100,400,0,1,1
3062,Casa del Rio,Piedra Black-on-white,1,800,920,120,1,1,1
3062,Casa del Rio,"PII/PIII Gray Rim, Type Undifferentiated",1,900,1300,400,0,0,0
3062,Casa del Rio,"PII/PIII White Ware, Type Undifferentiated",241,900,1300,400,0,1,1
3062,Casa del Rio,"PIII White Ware, Type Undifferentiated",50,1100,1300,200,1,1,1
3062,Casa del Rio,Puerco Black-on-white,16,1030,1200,170,1,1,1
3062,Casa del Rio,Red Mesa Black-on-white,214,880,1040,160,1,1,1
3062,Casa del Rio,"Red Ware type, Undifferentiated",2,700,1700,1000,0,0,0
3062,Casa del Rio,"San Juan Red ware, Undifferentiated",29,700,1050,350,0,0,1
3062,Casa del Rio,Sanostee Black-on-red,5,825,875,50,1,1,1
3062,Casa del Rio,Sheep Springs Gray,53,800,850,50,0,1,0
3062,Casa del Rio,Taylor Black-on-white,1,1000,1100,100,1,1,1
3062,Casa del Rio,Theodore Black-on-white,1,800,825,25,1,1,1
3062,Casa del Rio,Toadlena Black-on-white,13,975,1125,150,1,1,1
3062,Casa del Rio,"Tsegi Orange Ware, Undifferentiated",3,1000,1300,300,1,0,1
3062,Casa del Rio,Tunicha Black-on-white,13,850,900,50,1,1,1
3062,Casa del Rio,Tusayan Black-on-red,1,1045,1240,195,1,1,1
3062,Casa del Rio,"Tusayan White Ware, Undifferentiated",1,825,1300,475,0,1,1
3062,Casa del Rio,"Type, Undifferentiated",12,200,1900,1700,0,0,0
3062,Casa del Rio,White Mound Black-on-white,28,700,850,150,1,1,1
3062,Casa del Rio,"White Mountain type, Type Undifferentiated; Early",2,1000,1300,300,0,0,1
3062,Casa del Rio,"White ware, Undifferentiated",589,550,1900,1350,0,0,1
3062,Casa del Rio,Woodruff Smudged,3,500,1100,600,0,0,0
3063,Casa Escondida,Black Mesa/Sosi Black-on-white,2,1000,1180,180,1,1,1
3063,Casa Escondida,"BMIII/PI White Ware, Type Undifferentiated",4,550,900,350,0,1,1
3063,Casa Escondida,Chaco Black-on-white,10,1075,1150,75,1,1,1
3063,Casa Escondida,Chaco-McElmo Black-on-white (carbon paint),39,1090,1175,85,1,1,1
3063,Casa Escondida,"Chuska Carbon Painted White Ware, Undifferentiated",1,800,1300,500,0,1,1
3063,Casa Escondida,"Chuska Corrugated Gray Ware, Undifferentiated",34,890,1300,410,0,0,0
3063,Casa Escondida,"Chuska PII Gray, Type Undifferentiated",2,1040,1100,60,0,1,0
3063,Casa Escondida,"Cibola BMIII/PI White Ware, Type Undifferentiated",4,550,900,350,0,1,1
3063,Casa Escondida,"Cibola Corrugated Gray Ware, Undifferentiated",344,900,1400,500,0,0,0
3063,Casa Escondida,Cibola Narrow Neckbanded,4,900,1025,125,0,1,0
3063,Casa Escondida,Cibola Neck Indented Corrugated,2,950,1025,75,0,1,0
3063,Casa Escondida,"Cibola PII Gray Ware, Type Undifferentiated",8,950,1100,150,0,1,0
3063,Casa Escondida,"Cibola PII/PIII Gray Ware, Type Undifferentiated",12,950,1300,350,0,0,0
3063,Casa Escondida,"Cibola PIII Gray Ware, Type Undifferentiated",8,1100,1300,200,0,1,0
3063,Casa Escondida,Cibola Plain Gray,52,550,1040,490,0,0,0
3063,Casa Escondida,"Cibola White Ware, Undifferentiated",46,550,1325,775,0,1,1
3063,Casa Escondida,Escavada Black-on-white,28,1000,1100,100,1,1,1
3063,Casa Escondida,Gallup Black-on-white,36,1040,1150,110,1,1,1
3063,Casa Escondida,Lino Gray (Cibola),5,550,950,400,1,0,0
3063,Casa Escondida,Lino Gray Fugitive Red [Cibola Series],5,550,850,300,1,0,0
3063,Casa Escondida,McElmo Black-on-white,6,1060,1260,200,1,1,1
3063,Casa Escondida,"Mesa Verde White Ware, Undifferentiated",7,575,1280,705,0,1,1
3063,Casa Escondida,Nava Black-on-white,1,1100,1275,175,1,1,1
3063,Casa Escondida,"PII White Ware, Type Undifferentiated",7,900,1100,200,1,1,1
3063,Casa Escondida,"PII/PIII White Ware, Type Undifferentiated",52,900,1300,400,0,1,1
3063,Casa Escondida,Puerco Black-on-red,14,1000,1175,175,1,1,1
3063,Casa Escondida,Puerco Black-on-white,13,1030,1200,170,1,1,1
3063,Casa Escondida,Toadlena Black-on-white,7,975,1125,150,1,1,1
3063,Casa Escondida,"White Mountain type, Type Undifferentiated; Early",19,1000,1300,300,0,0,1
3063,Casa Escondida,"White ware, Undifferentiated",46,550,1900,1350,0,0,1
3063,Casa Escondida,Woodruff Smudged,4,500,1100,600,0,0,0
3064,Casa Estrella,Chaco Black-on-white,4,1075,1150,75,1,1,1
3064,Casa Estrella,Chaco-McElmo Black-on-white (carbon paint),2,1090,1175,85,1,1,1
3064,Casa Estrella,Cibola Clapboard Corrugated Gray,1,900,1100,200,0,1,0
3064,Casa Estrella,"Cibola Gray Ware, Undifferentiated",1,550,1400,850,0,0,0
3064,Casa Estrella,Cibola Indented Corrugated Gray,58,1040,1400,360,0,0,0
3064,Casa Estrella,Cibola Narrow Neckbanded,2,900,1025,125,0,1,0
3064,Casa Estrella,"Cibola PII Gray Ware, Type Undifferentiated",1,950,1100,150,0,1,0
3064,Casa Estrella,"Cibola PII/PIII Gray Ware, Type Undifferentiated",1,950,1300,350,0,0,0
3064,Casa Estrella,"Cibola PII/PIII White Ware, Type Undifferentiated",22,1000,1300,300,1,1,1
3064,Casa Estrella,Cibola Plain Gray,1,550,1040,490,0,0,0
3064,Casa Estrella,"Cibola White Ware, Undifferentiated",5,550,1325,775,0,1,1
3064,Casa Estrella,Escavada Black-on-white,4,1000,1100,100,1,1,1
3064,Casa Estrella,Escavada-Puerco Black-on-white,6,1000,1100,100,1,1,1
3064,Casa Estrella,Gallup Black-on-white,7,1040,1150,110,1,1,1
3064,Casa Estrella,Puerco Black-on-red,2,1000,1175,175,1,1,1
3064,Casa Estrella,"Puerco Valley Corrugated Gray Ware, Undifferentiated",9,800,1300,500,0,0,0
3064,Casa Estrella,"Puerco Valley Gray Ware, Undifferentiated",1,400,1300,900,0,0,0
3064,Casa Estrella,Red Mesa Black-on-white,1,880,1040,160,1,1,1
3064,Casa Estrella,Socorro Black-on-white,1,1050,1300,250,1,1,1
3064,Casa Estrella,Sosi Black-on-white,1,1070,1180,110,1,1,1
3064,Casa Estrella,"White Mountain type, Type Undifferentiated; Early",2,1000,1300,300,0,0,1
3064,Casa Estrella,Wingate Black-on-red,2,1050,1225,175,1,1,1
3065,Casa Negra,Chapin Gray,3,575,980,405,0,0,0
3065,Casa Negra,Cortez Black-on-white,27,880,1060,180,1,1,1
3065,Casa Negra,Deadmans (La Plata) Black-on-red,6,880,1050,170,1,1,1
3065,Casa Negra,Dolores Corrugated,5,1100,1200,100,0,1,0
3065,Casa Negra,"Gray Ware, Undifferentiated",1,400,1400,1000,0,0,0
3065,Casa Negra,Mancos Black-on-white,47,980,1180,200,1,1,1
3065,Casa Negra,Mancos Corrugated,24,920,1180,260,0,0,0
3065,Casa Negra,Mancos Gray,4,880,1060,180,0,1,0
3065,Casa Negra,McElmo Black-on-white,12,1060,1260,200,1,1,1
3065,Casa Negra,Mesa Verde Black-on-white,9,1180,1280,100,1,1,1
3065,Casa Negra,"Mesa Verde BMIII/PI White Ware, Type Undifferentiated",1,575,920,345,0,1,1
3065,Casa Negra,Mesa Verde Corrugated,2,1100,1280,180,0,1,0
3065,Casa Negra,"Mesa Verde Corrugated Gray Ware, Undifferentiated",320,920,1280,360,0,0,0
3065,Casa Negra,"Mesa Verde PII White Ware, Type Undifferentiated",2,920,1100,180,1,1,1
3065,Casa Negra,"Mesa Verde PII/PIII White Ware, Type Undifferentiated",27,920,1280,360,0,1,1
3065,Casa Negra,"Mesa Verde PIII White Ware, Type Undifferentiated",21,1100,1280,180,1,1,1
3065,Casa Negra,Mesa Verde Plain Gray,106,575,1020,445,0,0,0
3065,Casa Negra,Piedra Black-on-white,4,800,920,120,1,1,1
3065,Casa Negra,"Red Ware type, Undifferentiated",3,700,1700,1000,0,0,0
3065,Casa Negra,"San Juan Red ware, Undifferentiated",16,700,1050,350,0,0,1
3065,Casa Negra,"Tsegi Orange Ware, Undifferentiated",1,1000,1300,300,1,0,1
3065,Casa Negra,"White ware, Undifferentiated",232,550,1900,1350,0,0,1
3066,Casa Patricio,Cibola Narrow Neckbanded,2,900,1025,125,0,1,0
3066,Casa Patricio,Cibola Neckbanded Gray,7,850,1025,175,0,1,0
3066,Casa Patricio,Cibola Plain Gray,268,550,1040,490,0,0,0
3066,Casa Patricio,"Cibola White Ware, Undifferentiated",32,550,1325,775,0,1,1
3066,Casa Patricio,Cibola Wide Neckbanded,1,850,925,75,0,1,0
3066,Casa Patricio,"Corrugated Gray Ware, Undifferentiated",13,800,1400,600,0,0,0
3066,Casa Patricio,Escavada Black-on-white,2,1000,1100,100,1,1,1
3066,Casa Patricio,Gallup Black-on-white,8,1040,1150,110,1,1,1
3066,Casa Patricio,La Plata Black-on-white,14,550,750,200,1,1,1
3066,Casa Patricio,McElmo Black-on-white,4,1060,1260,200,1,1,1
3066,Casa Patricio,"Neckbanded Gray Ware, Undifferentiated",6,850,1025,175,0,1,0
3066,Casa Patricio,Red Mesa Black-on-white,22,880,1040,160,1,1,1
3066,Casa Patricio,Tusayan Corrugated,7,1020,1275,255,0,0,0
3066,Casa Patricio,"White Mountain type, Type Undifferentiated; Early",2,1000,1300,300,0,0,1
3066,Casa Patricio,"Wide Neckbanded Gray Ware, Type Undifferentiated",4,850,925,75,0,1,0
3067,Casa Rinconada,"BMIII/PI White Ware, Type Undifferentiated",2,550,900,350,0,1,1
3067,Casa Rinconada,Chaco Black-on-white,1,1075,1150,75,1,1,1
3067,Casa Rinconada,Chaco-McElmo Black-on-white (carbon paint),6,1090,1175,85,1,1,1
3067,Casa Rinconada,"Chuska BMIII/PI Black-on-white, Type Undifferentiated",1,700,900,200,1,1,1
3067,Casa Rinconada,Chuska Indented Corrugated Gray,8,1040,1300,260,0,0,0
3067,Casa Rinconada,"Chuska Mineral Painted White Ware, Undifferentiated",2,800,1300,500,0,1,1
3067,Casa Rinconada,"Chuska Plain Gray Ware, Type Undifferentiated",8,700,925,225,0,0,0
3067,Casa Rinconada,"Chuska White Ware type, Undifferentiated",1,800,1300,500,0,1,1
3067,Casa Rinconada,"Cibola Gray Ware, Undifferentiated",4,550,1400,850,0,0,0
3067,Casa Rinconada,Cibola Indented Corrugated Gray,34,1040,1400,360,0,0,0
3067,Casa Rinconada,Cibola Narrow Neckbanded,5,900,1025,125,0,1,0
3067,Casa Rinconada,Cibola Plain Gray,125,550,1040,490,0,0,0
3067,Casa Rinconada,Cibola Wide Neckbanded,4,850,925,75,0,1,0
3067,Casa Rinconada,Gallup Black-on-white,7,1040,1150,110,1,1,1
3067,Casa Rinconada,Lino Gray (Cibola),11,550,950,400,1,0,0
3067,Casa Rinconada,Mancos Black-on-white,1,980,1180,200,1,1,1
3067,Casa Rinconada,McElmo Black-on-white,2,1060,1260,200,1,1,1
3067,Casa Rinconada,"PII/PIII Gray Rim, Type Undifferentiated",1,900,1300,400,0,0,0
3067,Casa Rinconada,"PII/PIII White Ware, Type Undifferentiated",12,900,1300,400,0,1,1
3067,Casa Rinconada,Puerco Black-on-white,2,1030,1200,170,1,1,1
3067,Casa Rinconada,Red Mesa Black-on-white,7,880,1040,160,1,1,1
3067,Casa Rinconada,"San Juan Red ware, Undifferentiated",1,700,1050,350,0,0,1
3067,Casa Rinconada,"White Mountain type, Type Undifferentiated; Early",2,1000,1300,300,0,0,1
3067,Casa Rinconada,"White ware, Undifferentiated",55,550,1900,1350,0,0,1
3068,Casamero,Chaco Black-on-white,1,1075,1150,75,1,1,1
3068,Casamero,Chaco-McElmo Black-on-white (carbon paint),1,1090,1175,85,1,1,1
3068,Casamero,"Chuska White Ware type, Undifferentiated",20,800,1300,500,0,1,1
3068,Casamero,"Cibola Black-on-white, Undifferentiated",14,550,1325,775,0,1,1
3068,Casamero,Cibola Clapboard Corrugated Gray,12,900,1100,200,0,1,0
3068,Casamero,"Cibola Corrugated Gray Ware, Undifferentiated",9,900,1400,500,0,0,0
3068,Casamero,Cibola Indented Corrugated Gray,133,1040,1400,360,0,0,0
3068,Casamero,Cibola Narrow Neckbanded,1,900,1025,125,0,1,0
3068,Casamero,Cibola Narrow Neckbanded Gray,1,900,1025,125,0,1,0
3068,Casamero,Cibola Neck Indented Corrugated,1,950,1025,75,0,1,0
3068,Casamero,Cibola Neckbanded Gray,4,850,1025,175,0,1,0
3068,Casamero,"Cibola PII Gray Ware, Type Undifferentiated",4,950,1100,150,0,1,0
3068,Casamero,"Cibola PII/PIII White Ware, Type Undifferentiated",26,1000,1300,300,1,1,1
3068,Casamero,Cibola Plain Gray,55,550,1040,490,0,0,0
3068,Casamero,"Cibola White Ware, Undifferentiated",11,550,1325,775,0,1,1
3068,Casamero,Deadmans (La Plata) Black-on-red,1,880,1050,170,1,1,1
3068,Casamero,Escavada-Puerco Black-on-white,5,1000,1100,100,1,1,1
3068,Casamero,Gallup Black-on-white,43,1040,1150,110,1,1,1
3068,Casamero,Puerco Black-on-white,1,1030,1200,170,1,1,1
3068,Casamero,Red Mesa Black-on-white,11,880,1040,160,1,1,1
3068,Casamero,"Type, Undifferentiated",3,200,1900,1700,0,0,0
3068,Casamero,"White ware, Undifferentiated",1,550,1900,1350,0,0,1
3068,Casamero,Wingate Black-on-red,1,1050,1225,175,1,1,1
3069,Cerro Pomo,"Cibola Gray Ware, Undifferentiated",719,550,1400,850,0,0,0
3069,Cerro Pomo,Kiatuthlanna Black-on-white,7,850,925,75,1,1,1
3069,Cerro Pomo,"Mogollon Brown ware, Undifferentiated",4191,900,1400,500,0,0,0
3069,Cerro Pomo,"Mogollon Plain Brown Ware, Smudged",2069,300,1400,1100,0,0,0
3069,Cerro Pomo,Puerco Black-on-red,53,1000,1175,175,1,1,1
3069,Cerro Pomo,Puerco Black-on-white,789,1030,1200,170,1,1,1
3069,Cerro Pomo,Red Mesa Black-on-white,49,880,1040,160,1,1,1
3069,Cerro Pomo,Reserve Black-on-white,741,1050,1200,150,1,1,1
3069,Cerro Pomo,Wingate Black-on-red or Polychrome,136,1050,1225,175,1,1,1
3070,Chaco East,Black Mesa Black-on-white,1,1000,1100,100,1,1,1
3070,Chaco East,Chaco Black-on-white,10,1075,1150,75,1,1,1
3070,Chaco East,Chaco-McElmo Black-on-white (carbon paint),15,1090,1175,85,1,1,1
3070,Chaco East,Chuska Black-on-white,1,1040,1125,85,1,1,1
3070,Chaco East,"Chuska Carbon Painted White Ware, Undifferentiated",3,800,1300,500,0,1,1
3070,Chaco East,"Chuska Corrugated Gray Ware, Undifferentiated",58,890,1300,410,0,0,0
3070,Chaco East,"Chuska Gray Ware, Type Undifferentiated",5,700,1300,600,0,0,0
3070,Chaco East,"Chuska PII Gray, Type Undifferentiated",1,1040,1100,60,0,1,0
3070,Chaco East,"Chuska PII/PIII Gray, Type Undifferentiated",2,1040,1300,260,0,0,0
3070,Chaco East,"Chuska PIII Gray, Type Undifferentiated",1,1100,1300,200,0,1,0
3070,Chaco East,"Chuska Plain Gray Ware, Type Undifferentiated",8,700,925,225,0,0,0
3070,Chaco East,"Cibola Corrugated Gray Ware, Undifferentiated",152,900,1400,500,0,0,0
3070,Chaco East,"Cibola Gray Ware, Undifferentiated",8,550,1400,850,0,0,0
3070,Chaco East,Cibola Narrow Neckbanded,24,900,1025,125,0,1,0
3070,Chaco East,Cibola Neck Indented Corrugated,4,950,1025,75,0,1,0
3070,Chaco East,"Cibola PII Gray Ware, Type Undifferentiated",2,950,1100,150,0,1,0
3070,Chaco East,"Cibola PII/PIII Gray Ware, Type Undifferentiated",3,950,1300,350,0,0,0
3070,Chaco East,"Cibola PIII Gray Ware, Type Undifferentiated",2,1100,1300,200,0,1,0
3070,Chaco East,Cibola Plain Gray,50,550,1040,490,0,0,0
3070,Chaco East,Cibola Wide Neckbanded,19,850,925,75,0,1,0
3070,Chaco East,Dogoszhi Black-on-white,1,1040,1210,170,1,1,1
3070,Chaco East,Escavada Black-on-white,1,1000,1100,100,1,1,1
3070,Chaco East,Gallup Black-on-white,90,1040,1150,110,1,1,1
3070,Chaco East,Gray Hills Banded,8,850,950,100,0,1,0
3070,Chaco East,Kana-a Black-on-white,1,825,1000,175,1,1,1
3070,Chaco East,Kiatuthlanna Black-on-white,4,850,925,75,1,1,1
3070,Chaco East,La Plata Black-on-white,1,550,750,200,1,1,1
3070,Chaco East,"Little Colorado White Ware, Undifferentiated",1,825,1250,425,0,1,1
3070,Chaco East,Mancos Black-on-white,1,980,1180,200,1,1,1
3070,Chaco East,McElmo Black-on-white,4,1060,1260,200,1,1,1
3070,Chaco East,Mesa Verde Black-on-white,2,1180,1280,100,1,1,1
3070,Chaco East,"Mesa Verde White Ware, Undifferentiated",1,575,1280,705,0,1,1
3070,Chaco East,Nava Black-on-white,1,1100,1275,175,1,1,1
3070,Chaco East,Newcomb Black-on-white,1,875,1000,125,1,1,1
3070,Chaco East,"PII/PIII White Ware, Type Undifferentiated",68,900,1300,400,0,1,1
3070,Chaco East,Puerco Black-on-red,3,1000,1175,175,1,1,1
3070,Chaco East,Puerco Black-on-white,25,1030,1200,170,1,1,1
3070,Chaco East,Red Mesa Black-on-white,58,880,1040,160,1,1,1
3070,Chaco East,Sosi Black-on-white,1,1070,1180,110,1,1,1
3070,Chaco East,"Tsegi Orange Ware, Undifferentiated",3,1000,1300,300,1,0,1
3070,Chaco East,Tusayan Black-on-red,2,1045,1240,195,1,1,1
3070,Chaco East,"White Mountain type, Type Undifferentiated; Early",8,1000,1300,300,0,0,1
3070,Chaco East,"White ware, Undifferentiated",108,550,1900,1350,0,0,1
3070,Chaco East,Wingate Black-on-red,1,1050,1225,175,1,1,1
3070,Chaco East,Woodruff Smudged,4,500,1100,600,0,0,0
3071,Chacra Mesa Great Kiva,Brimhall Black-on-white,2,1040,1150,110,1,1,1
3071,Chacra Mesa Great Kiva,Cameron Polychrome,1,1040,1170,130,1,1,1
3071,Chacra Mesa Great Kiva,Chaco-McElmo Black-on-white (carbon paint),8,1090,1175,85,1,1,1
3071,Chacra Mesa Great Kiva,Chuska Black-on-white,3,1040,1125,85,1,1,1
3071,Chacra Mesa Great Kiva,"Chuska Carbon Painted White Ware, Undifferentiated",1,800,1300,500,0,1,1
3071,Chacra Mesa Great Kiva,"Chuska Corrugated Gray Ware, Undifferentiated",21,890,1300,410,0,0,0
3071,Chacra Mesa Great Kiva,"Chuska PII Gray, Type Undifferentiated",2,1040,1100,60,0,1,0
3071,Chacra Mesa Great Kiva,"Cibola Corrugated Gray Ware, Undifferentiated",133,900,1400,500,0,0,0
3071,Chacra Mesa Great Kiva,Cibola Narrow Neckbanded,8,900,1025,125,0,1,0
3071,Chacra Mesa Great Kiva,"Cibola PII Gray Ware, Type Undifferentiated",14,950,1100,150,0,1,0
3071,Chacra Mesa Great Kiva,"Cibola PII/PIII Gray Ware, Type Undifferentiated",1,950,1300,350,0,0,0
3071,Chacra Mesa Great Kiva,Cibola Plain Gray,17,550,1040,490,0,0,0
3071,Chacra Mesa Great Kiva,"Cibola White Ware, Undifferentiated",59,550,1325,775,0,1,1
3071,Chacra Mesa Great Kiva,Cibola Wide Neckbanded,1,850,925,75,0,1,0
3071,Chacra Mesa Great Kiva,"Corrugated Gray Ware, Undifferentiated",154,800,1400,600,0,0,0
3071,Chacra Mesa Great Kiva,Escavada Black-on-white,24,1000,1100,100,1,1,1
3071,Chacra Mesa Great Kiva,Gallup Black-on-white,42,1040,1150,110,1,1,1
3071,Chacra Mesa Great Kiva,Mancos Black-on-white,20,980,1180,200,1,1,1
3071,Chacra Mesa Great Kiva,McElmo Black-on-white,32,1060,1260,200,1,1,1
3071,Chacra Mesa Great Kiva,Mesa Verde Black-on-white,8,1180,1280,100,1,1,1
3071,Chacra Mesa Great Kiva,"Mesa Verde White Ware, Undifferentiated",30,575,1280,705,0,1,1
3071,Chacra Mesa Great Kiva,"PII/PIII Gray Rim, Type Undifferentiated",1,900,1300,400,0,0,0
3071,Chacra Mesa Great Kiva,"PII/PIII White Ware, Type Undifferentiated",86,900,1300,400,0,1,1
3071,Chacra Mesa Great Kiva,"Plain Gray Ware, Undifferentiated",17,500,1300,800,0,0,0
3071,Chacra Mesa Great Kiva,"Polychrome, Undifferentiated",1,700,1900,1200,0,1,1
3071,Chacra Mesa Great Kiva,Puerco Black-on-red,2,1000,1175,175,1,1,1
3071,Chacra Mesa Great Kiva,Puerco Black-on-white,4,1030,1200,170,1,1,1
3071,Chacra Mesa Great Kiva,Red Mesa Black-on-white,6,880,1040,160,1,1,1
3071,Chacra Mesa Great Kiva,Toadlena Black-on-white,2,975,1125,150,1,1,1
3071,Chacra Mesa Great Kiva,"Tsegi Orange Ware, Undifferentiated",4,1000,1300,300,1,0,1
3071,Chacra Mesa Great Kiva,Tusayan Black-on-red,2,1045,1240,195,1,1,1
3071,Chacra Mesa Great Kiva,"White Mountain type, Type Undifferentiated; Early",8,1000,1300,300,0,0,1
3071,Chacra Mesa Great Kiva,"White ware, Undifferentiated",59,550,1900,1350,0,0,1
3071,Chacra Mesa Great Kiva,"Wide Neckbanded Gray Ware, Type Undifferentiated",1,850,925,75,0,1,0
3071,Chacra Mesa Great Kiva,Wingate Black-on-red,6,1050,1225,175,1,1,1
3072,Chambers Great House,Chaco Black-on-white,2,1075,1150,75,1,1,1
3072,Chambers Great House,Chaco-McElmo Black-on-white (carbon paint),4,1090,1175,85,1,1,1
3072,Chambers Great House,Cibola Clapboard Corrugated Gray,14,900,1100,200,0,1,0
3072,Chambers Great House,Cibola Indented Corrugated Gray,112,1040,1400,360,0,0,0
3072,Chambers Great House,Cibola Narrow Neckbanded,4,900,1025,125,0,1,0
3072,Chambers Great House,"Cibola PII Gray Ware, Type Undifferentiated",2,950,1100,150,0,1,0
3072,Chambers Great House,"Cibola PII/PIII Gray Ware, Type Undifferentiated",10,950,1300,350,0,0,0
3072,Chambers Great House,"Cibola PII/PIII White Ware, Type Undifferentiated",26,1000,1300,300,1,1,1
3072,Chambers Great House,"Cibola PIII Gray Ware, Type Undifferentiated",8,1100,1300,200,0,1,0
3072,Chambers Great House,"Cibola White Ware, Undifferentiated",18,550,1325,775,0,1,1
3072,Chambers Great House,Escavada Black-on-white,26,1000,1100,100,1,1,1
3072,Chambers Great House,Gallup Black-on-white,12,1040,1150,110,1,1,1
3072,Chambers Great House,Holbrook B Black-on-white,4,1050,1150,100,1,1,1
3072,Chambers Great House,"Little Colorado White Ware, Undifferentiated",4,825,1250,425,0,1,1
3072,Chambers Great House,"Plain Gray Ware, Undifferentiated",2,500,1300,800,0,0,0
3072,Chambers Great House,Puerco Black-on-white,6,1030,1200,170,1,1,1
3072,Chambers Great House,"Puerco Valley Corrugated Gray Ware, Undifferentiated",18,800,1300,500,0,0,0
3072,Chambers Great House,"Puerco Valley Gray Ware, Undifferentiated",6,400,1300,900,0,0,0
3072,Chambers Great House,Red Mesa Black-on-white,12,880,1040,160,1,1,1
3072,Chambers Great House,Reserve Black-on-white,10,1050,1200,150,1,1,1
3072,Chambers Great House,Showlow Black-on-red,10,1030,1200,170,1,1,1
3072,Chambers Great House,Showlow Red,6,1000,1100,100,0,1,0
3072,Chambers Great House,Showlow Red Corrugated,4,1030,1280,250,0,0,0
3072,Chambers Great House,Sosi Black-on-white,2,1070,1180,110,1,1,1
3072,Chambers Great House,St. Johns Polychrome,2,1200,1300,100,1,1,1
3072,Chambers Great House,Tusayan A Polychrome,2,1110,1320,210,1,1,1
3072,Chambers Great House,White Mound Black-on-white,2,700,850,150,1,1,1
3072,Chambers Great House,"White ware, Undifferentiated",2,550,1900,1350,0,0,1
3072,Chambers Great House,Wingate Black-on-red,2,1050,1225,175,1,1,1
3072,Chambers Great House,Woodruff Brown,4,500,1100,600,0,0,0
3072,Chambers Great House,Woodruff Smudged,6,500,1100,600,0,0,0
3073,Chetro Ketl,Black Mesa Black-on-white,1,1000,1100,100,1,1,1
3073,Chetro Ketl,Black Mesa/Sosi Black-on-white,31,1000,1180,180,1,1,1
3073,Chetro Ketl,Chaco Black-on-white,53,1075,1150,75,1,1,1
3073,Chetro Ketl,Chaco-McElmo Black-on-white (carbon paint),169,1090,1175,85,1,1,1
3073,Chetro Ketl,Chuska Black-on-white,13,1040,1125,85,1,1,1
3073,Chetro Ketl,"Chuska Carbon Painted White Ware, Undifferentiated",24,800,1300,500,0,1,1
3073,Chetro Ketl,"Cibola White Ware, Undifferentiated",161,550,1325,775,0,1,1
3073,Chetro Ketl,"Corrugated Gray Ware, Undifferentiated",504,800,1400,600,0,0,0
3073,Chetro Ketl,Crumbled House Black-on-white,2,1150,1300,150,1,1,1
3073,Chetro Ketl,Dogoszhi Black-on-white,2,1040,1210,170,1,1,1
3073,Chetro Ketl,Escavada Black-on-white,2,1000,1100,100,1,1,1
3073,Chetro Ketl,Gallup Black-on-white,286,1040,1150,110,1,1,1
3073,Chetro Ketl,Holbrook Black-on-white,21,1050,1150,100,1,1,1
3073,Chetro Ketl,Mancos Black-on-white,57,980,1180,200,1,1,1
3073,Chetro Ketl,McElmo Black-on-white,176,1060,1260,200,1,1,1
3073,Chetro Ketl,Mesa Verde Black-on-white,18,1180,1280,100,1,1,1
3073,Chetro Ketl,"Mesa Verde White Ware, Undifferentiated",25,575,1280,705,0,1,1
3073,Chetro Ketl,"Narrow Neckbanded Gray Ware, Type Undifferentiated",27,900,1025,125,0,1,0
3073,Chetro Ketl,Nava Black-on-white,8,1100,1275,175,1,1,1
3073,Chetro Ketl,"Neck Indented Corrugated Gray Ware, Type Undifferentiated",1,950,1025,75,0,1,0
3073,Chetro Ketl,Newcomb or Burnham Black-on-white,2,860,1000,140,1,1,1
3073,Chetro Ketl,"PII Gray Rim, Type Undifferentiated",9,900,1100,200,0,1,0
3073,Chetro Ketl,"PII/PIII Gray Rim, Type Undifferentiated",5,900,1300,400,0,0,0
3073,Chetro Ketl,"PII/PIII White Ware, Type Undifferentiated",161,900,1300,400,0,1,1
3073,Chetro Ketl,"Plain Gray Ware, Undifferentiated",5,500,1300,800,0,0,0
3073,Chetro Ketl,Puerco Black-on-red,3,1000,1175,175,1,1,1
3073,Chetro Ketl,Puerco Black-on-white,130,1030,1200,170,1,1,1
3073,Chetro Ketl,Red Mesa Black-on-white,21,880,1040,160,1,1,1
3073,Chetro Ketl,Socorro Black-on-white,6,1050,1300,250,1,1,1
3073,Chetro Ketl,Toadlena Black-on-white,36,975,1125,150,1,1,1
3073,Chetro Ketl,"Tsegi Orange Ware, Undifferentiated",8,1000,1300,300,1,0,1
3073,Chetro Ketl,Tularosa Black-on-white,2,1180,1300,120,1,1,1
3073,Chetro Ketl,"Tusayan White Ware, Undifferentiated",2,825,1300,475,0,1,1
3073,Chetro Ketl,"White Mountain type, Type Undifferentiated; Early",2,1000,1300,300,0,0,1
3073,Chetro Ketl,Wingate Black-on-red,1,1050,1225,175,1,1,1
3073,Chetro Ketl,Woodruff Smudged,16,500,1100,600,0,0,0
3074,Chimney Rock,Arboles Black-on-white,15,950,1050,100,1,1,1
3074,Chimney Rock,Bancos Black-on-white,2,825,1000,175,1,1,1
3074,Chimney Rock,Bennett Gray,2,700,850,150,0,1,0
3074,Chimney Rock,Brimhall Black-on-white,1,1040,1150,110,1,1,1
3074,Chimney Rock,Chaco Black-on-white,8,1075,1150,75,1,1,1
3074,Chimney Rock,"Chuska Mineral Painted White Ware, Undifferentiated",1,800,1300,500,0,1,1
3074,Chimney Rock,Cibola Plain Gray,1,550,1040,490,0,0,0
3074,Chimney Rock,"Cibola White Ware, Undifferentiated",3,550,1325,775,0,1,1
3074,Chimney Rock,Cortez Black-on-white,3,880,1060,180,1,1,1
3074,Chimney Rock,"Decorated Type, Undifferentiated",8,300,1900,1600,0,0,1
3074,Chimney Rock,Dolores Corrugated,31,1100,1200,100,0,1,0
3074,Chimney Rock,Escavada Black-on-white,3,1000,1100,100,1,1,1
3074,Chimney Rock,Gallup Black-on-white,26,1040,1150,110,1,1,1
3074,Chimney Rock,Mancos Black-on-white,226,980,1180,200,1,1,1
3074,Chimney Rock,Mancos Corrugated,448,920,1180,260,0,0,0
3074,Chimney Rock,Mesa Verde Corrugated,120,1100,1280,180,0,1,0
3074,Chimney Rock,"Mesa Verde Corrugated Gray Ware, Undifferentiated",753,920,1280,360,0,0,0
3074,Chimney Rock,"Mesa Verde Gray ware, Undifferentiated",16,575,1280,705,0,0,0
3074,Chimney Rock,"Mesa Verde PII White Ware, Type Undifferentiated",30,920,1100,180,1,1,1
3074,Chimney Rock,Mesa Verde Plain Gray,72,575,1020,445,0,0,0
3074,Chimney Rock,"Mesa Verde White Ware, Undifferentiated",17,575,1280,705,0,1,1
3074,Chimney Rock,Mummy Lake Gray,2,1150,1280,130,0,1,0
3074,Chimney Rock,Payan Corrugated,52,1000,1200,200,0,1,0
3074,Chimney Rock,Piedra Black-on-white,5,800,920,120,1,1,1
3074,Chimney Rock,Red Mesa Black-on-white,2,880,1040,160,1,1,1
3074,Chimney Rock,"Red Ware type, Undifferentiated",2,700,1700,1000,0,0,0
3074,Chimney Rock,Rosa Gray,1,700,1000,300,0,0,0
3074,Chimney Rock,Taylor Black-on-white,10,1000,1100,100,1,1,1
3074,Chimney Rock,Tusayan Black-on-red,7,1045,1240,195,1,1,1
3074,Chimney Rock,Tusayan Polychrome,1,1110,1320,210,1,1,1
3074,Chimney Rock,"Upper San Juan White Ware, Undifferentiated",63,700,1300,600,0,1,1
3074,Chimney Rock,Wetherill Black-on-white,47,1060,1180,120,1,1,1
3074,Chimney Rock,"White Mountain type, Type Undifferentiated; Early",1,1000,1300,300,0,0,1
3075,Church Rock,Chuska Indented Corrugated Gray,2,1040,1300,260,0,0,0
3075,Church Rock,Cibola Indented Corrugated Gray,5,1040,1400,360,0,0,0
3075,Church Rock,"Cibola White Ware, Undifferentiated",9,550,1325,775,0,1,1
3075,Church Rock,Escavada Black-on-white,10,1000,1100,100,1,1,1
3075,Church Rock,Gallup Black-on-white,8,1040,1150,110,1,1,1
3075,Church Rock,"Gray Ware, Undifferentiated",1,400,1400,1000,0,0,0
3075,Church Rock,"Mesa Verde Corrugated Gray Ware, Undifferentiated",1,920,1280,360,0,0,0
3075,Church Rock,Red Mesa Black-on-white,6,880,1040,160,1,1,1
3075,Church Rock,Reserve Black-on-white,2,1050,1200,150,1,1,1
3075,Church Rock,Toadlena Black-on-white,1,975,1125,150,1,1,1
3075,Church Rock,"White ware, Undifferentiated",2,550,1900,1350,0,0,1
3076,Cline Point,Black Mesa Black-on-white,4,1000,1100,100,1,1,1
3076,Cline Point,"Cibola Gray Ware, Undifferentiated",18,550,1400,850,0,0,0
3076,Cline Point,"Cibola PII/PIII White Ware, Type Undifferentiated",752,1000,1300,300,1,1,1
3076,Cline Point,"Cibola White Ware, Undifferentiated",1249,550,1325,775,0,1,1
3076,Cline Point,Escavada Black-on-white,136,1000,1100,100,1,1,1
3076,Cline Point,Gallup Black-on-white,20,1040,1150,110,1,1,1
3076,Cline Point,Holbrook B Black-on-white,4,1050,1150,100,1,1,1
3076,Cline Point,Little Colorado Clapboard Corrugated Gray,1,900,1100,200,0,1,0
3076,Cline Point,"Little Colorado Gray Ware, Undifferentiated",1,850,1300,450,0,0,0
3076,Cline Point,Little Colorado Indented Corrugated Gray,9,1050,1300,250,0,0,0
3076,Cline Point,"Little Colorado White Ware, Undifferentiated",62,825,1250,425,0,1,1
3076,Cline Point,"Mogollon Brown ware, Undifferentiated",963,900,1400,500,0,0,0
3076,Cline Point,"Mogollon Corrugated Brown Ware, Undifferentiated",65,800,1400,600,0,0,0
3076,Cline Point,Mogollon Indented Corrugated Brown Ware,3128,1000,1400,400,0,0,0
3076,Cline Point,"Mogollon Indented Corrugated Brown Ware, Smudged",4,1000,1400,400,0,0,0
3076,Cline Point,Mogollon Patterned Corrugated Brown Ware,6,1000,1400,400,0,0,0
3076,Cline Point,"Mogollon Plain Brown Ware, Smudged",30,300,1400,1100,0,0,0
3076,Cline Point,Mogollon Zoned Corrugated Brown Ware,1,1000,1400,400,0,0,0
3076,Cline Point,"Plain Gray Ware, Undifferentiated",4,500,1300,800,0,0,0
3076,Cline Point,Puerco Black-on-white,20,1030,1200,170,1,1,1
3076,Cline Point,Red Mesa Black-on-white,45,880,1040,160,1,1,1
3076,Cline Point,"Red Ware type, Undifferentiated",2,700,1700,1000,0,0,0
3076,Cline Point,Reserve Black-on-white,16,1050,1200,150,1,1,1
3076,Cline Point,Salado Red,10,1150,1450,300,0,0,0
3076,Cline Point,Showlow Black-on-red,2,1030,1200,170,1,1,1
3076,Cline Point,Showlow Red,9,1000,1100,100,0,1,0
3076,Cline Point,Snowflake Black-on-white,18,1100,1275,175,1,1,1
3076,Cline Point,Sosi Black-on-white,4,1070,1180,110,1,1,1
3076,Cline Point,"Tusayan White Ware, Undifferentiated",27,825,1300,475,0,1,1
3076,Cline Point,"Type, Undifferentiated",43,200,1900,1700,0,0,0
3076,Cline Point,"White Mountain type, Type Undifferentiated; Early",3,1000,1300,300,0,0,1
3076,Cline Point,Woodruff Brown,6,500,1100,600,0,0,0
3076,Cline Point,Woodruff Red Smudged,31,400,1100,700,0,0,0
3078,Coalbed Village,Abajo Red-on-orange,12,760,880,120,1,1,1
3078,Coalbed Village,Jeddito Black-on-yellow,1,1300,1450,150,1,1,1
3078,Coalbed Village,Mancos Black-on-white,55,980,1180,200,1,1,1
3078,Coalbed Village,Mancos Corrugated,27,920,1180,260,0,0,0
3078,Coalbed Village,Mancos Gray,8,880,1060,180,0,1,0
3078,Coalbed Village,Mesa Verde Black-on-white,16,1180,1280,100,1,1,1
3078,Coalbed Village,Mesa Verde Corrugated,80,1100,1280,180,0,1,0
3078,Coalbed Village,Moccasin Gray,2,800,980,180,0,1,0
3078,Coalbed Village,"PII/PIII Gray Rim, Type Undifferentiated",40,900,1300,400,0,0,0
3079,Comb Wash,"Mesa Verde Corrugated Gray Ware, Undifferentiated",26,920,1280,360,0,0,0
3079,Comb Wash,Mesa Verde Plain Gray,26,575,1020,445,0,0,0
3079,Comb Wash,"Mesa Verde White Ware, Undifferentiated",11,575,1280,705,0,1,1
3081,Coolidge,Chaco-McElmo Black-on-white (carbon paint),1,1090,1175,85,1,1,1
3081,Coolidge,"Cibola Black-on-white, Undifferentiated",15,550,1325,775,0,1,1
3081,Coolidge,Cibola Indented Corrugated Gray,36,1040,1400,360,0,0,0
3081,Coolidge,Cibola Neckbanded Gray,2,850,1025,175,0,1,0
3081,Coolidge,Cibola Plain Gray,44,550,1040,490,0,0,0
3081,Coolidge,Escavada-Puerco Black-on-white,16,1000,1100,100,1,1,1
3081,Coolidge,Gallup Black-on-white,11,1040,1150,110,1,1,1
3081,Coolidge,Puerco Black-on-red,5,1000,1175,175,1,1,1
3081,Coolidge,Red Mesa Black-on-white,15,880,1040,160,1,1,1
3081,Coolidge,"White Mountain type, Type Undifferentiated; Early",2,1000,1300,300,0,0,1
3081,Coolidge,Woodruff Smudged,4,500,1100,600,0,0,0
3083,Cothruns,Aquarius Orange,1,1000,1100,100,0,1,0
3083,Cothruns,Black Mesa Black-on-white,14,1000,1100,100,1,1,1
3083,Cothruns,"Cibola BMIII/PI White Ware, Type Undifferentiated",3,550,900,350,0,1,1
3083,Cothruns,"Cibola Gray Ware, Undifferentiated",32,550,1400,850,0,0,0
3083,Cothruns,"Cibola PII/PIII White Ware, Type Undifferentiated",804,1000,1300,300,1,1,1
3083,Cothruns,"Cibola PIII/PIV White Ware, Type Undifferentiated",2,1200,1325,125,1,1,1
3083,Cothruns,"Cibola White Ware, Undifferentiated",1910,550,1325,775,0,1,1
3083,Cothruns,Deadmans (La Plata) Black-on-red,8,880,1050,170,1,1,1
3083,Cothruns,Escavada Black-on-white,31,1000,1100,100,1,1,1
3083,Cothruns,Gallup Black-on-white,6,1040,1150,110,1,1,1
3083,Cothruns,Holbrook A Black-on-white,3,1050,1150,100,1,1,1
3083,Cothruns,Holbrook B Black-on-white,77,1050,1150,100,1,1,1
3083,Cothruns,Kiatuthlanna Black-on-white,6,850,925,75,1,1,1
3083,Cothruns,"Little Colorado Gray Ware, Undifferentiated",26,850,1300,450,0,0,0
3083,Cothruns,Little Colorado Indented Corrugated Gray,143,1050,1300,250,0,0,0
3083,Cothruns,"Little Colorado Plain Gray, Undifferentiated",3,550,1040,490,0,0,0
3083,Cothruns,"Little Colorado White Ware, Undifferentiated",58,825,1250,425,0,1,1
3083,Cothruns,McDonald Corrugated,3,1150,1280,130,1,1,1
3083,Cothruns,"Middle Gila Buff Ware or Gray Ware, Undifferentiated",1,300,1350,1050,0,1,1
3083,Cothruns,"Mogollon Brown ware, Undifferentiated",653,900,1400,500,0,0,0
3083,Cothruns,"Mogollon Corrugated Brown Ware, Undifferentiated",606,800,1400,600,0,0,0
3083,Cothruns,Mogollon Indented Corrugated Brown Ware,2037,1000,1400,400,0,0,0
3083,Cothruns,"Mogollon Indented Corrugated Brown Ware, Smudged",27,1000,1400,400,0,0,0
3083,Cothruns,Mogollon Obliterated Corrugated Brown,13,1000,1400,400,0,0,0
3083,Cothruns,Mogollon Patterned Corrugated Brown Ware,64,1000,1400,400,0,0,0
3083,Cothruns,Mogollon Plain Brown Ware,2395,300,1400,1100,0,0,0
3083,Cothruns,"Mogollon Plain Brown Ware, Smudged",173,300,1400,1100,0,0,0
3083,Cothruns,Mogollon Zoned Corrugated Brown Ware,58,1000,1400,400,0,0,0
3083,Cothruns,"PII/PIII Gray Rim, Type Undifferentiated",1,900,1300,400,0,0,0
3083,Cothruns,"PIII Gray Rim, Type Undifferentiated",2,1100,1300,200,0,1,0
3083,Cothruns,Puerco Black-on-white,50,1030,1200,170,1,1,1
3083,Cothruns,"Puerco Valley Red Ware, Undifferentiated",120,1000,1200,200,0,1,0
3083,Cothruns,Red Mesa Black-on-white,79,880,1040,160,1,1,1
3083,Cothruns,Reserve Black-on-white,12,1050,1200,150,1,1,1
3083,Cothruns,Reserve/Tularosa Black-on-white,3,1050,1300,250,1,1,1
3083,Cothruns,"San Juan Red ware, Undifferentiated",4,700,1050,350,0,0,1
3083,Cothruns,Showlow Black-on-red,28,1030,1200,170,1,1,1
3083,Cothruns,Showlow Black-on-red Corrugated,5,1050,1200,150,1,1,1
3083,Cothruns,Showlow Red,216,1000,1100,100,0,1,0
3083,Cothruns,Showlow Red Corrugated,87,1030,1280,250,0,0,0
3083,Cothruns,Snowflake Black-on-white,28,1100,1275,175,1,1,1
3083,Cothruns,Sosi Black-on-white,26,1070,1180,110,1,1,1
3083,Cothruns,Three Circle Neck Corrugated,6,800,1000,200,0,1,0
3083,Cothruns,"Tsegi Orange Ware, Undifferentiated",2,1000,1300,300,1,0,1
3083,Cothruns,Tularosa White-on-red,4,1200,1350,150,1,1,1
3083,Cothruns,"Tusayan BMIII/PI White Ware, Type Undifferentiated",1,600,900,300,1,1,1
3083,Cothruns,"Tusayan PII/PIII White Ware, Type Undifferentiated",49,900,1300,400,0,1,1
3083,Cothruns,"Tusayan White Ware, Undifferentiated",55,825,1300,475,0,1,1
3083,Cothruns,"White Mountain type, Type Undifferentiated; Early",9,1000,1300,300,0,0,1
3083,Cothruns,Woodruff Brown,51,500,1100,600,0,0,0
3083,Cothruns,Woodruff Smudged,327,500,1100,600,0,0,0
3084,Cottonwood Falls,Abajo Red-on-orange,44,760,880,120,1,1,1
3084,Cottonwood Falls,Bluff Black-on-red,207,800,925,125,1,1,1
3084,Cottonwood Falls,Chapin Gray,233,575,980,405,0,0,0
3084,Cottonwood Falls,Citadel Polychrome,4,1040,1200,160,1,1,1
3084,Cottonwood Falls,Deadmans (La Plata) Black-on-red,150,880,1050,170,1,1,1
3084,Cottonwood Falls,Dogoszhi Polychrome,2,1040,1320,280,1,1,1
3084,Cottonwood Falls,Dolores Corrugated,17,1100,1200,100,0,1,0
3084,Cottonwood Falls,Dolores Red,1,550,900,350,0,0,0
3084,Cottonwood Falls,Flagstaff Black-on-white,2,1150,1220,70,1,1,1
3084,Cottonwood Falls,Mancos Corrugated,23,920,1180,260,0,0,0
3084,Cottonwood Falls,Mancos Gray,149,880,1060,180,0,1,0
3084,Cottonwood Falls,McElmo Black-on-white,151,1060,1260,200,1,1,1
3084,Cottonwood Falls,Medicine Black-on-red,3,1040,1170,130,1,1,1
3084,Cottonwood Falls,Mesa Verde Black-on-white,47,1180,1280,100,1,1,1
3084,Cottonwood Falls,"Mesa Verde Corrugated Gray Ware, Undifferentiated",9,920,1280,360,0,0,0
3084,Cottonwood Falls,"Mesa Verde White Ware, Undifferentiated",1296,575,1280,705,0,1,1
3084,Cottonwood Falls,Moccasin Gray,142,800,980,180,0,1,0
3084,Cottonwood Falls,"Orange Ware, Undifferentiated",170,1000,1350,350,0,0,0
3084,Cottonwood Falls,"Plain Gray Ware, Undifferentiated",15,500,1300,800,0,0,0
3084,Cottonwood Falls,"Red Ware type, Undifferentiated",159,700,1700,1000,0,0,0
3084,Cottonwood Falls,Sanostee Red-on-Orange,1,825,875,50,1,1,1
3084,Cottonwood Falls,Tusayan Corrugated,1,1020,1275,255,0,0,0
3084,Cottonwood Falls,"Type, Undifferentiated",48,200,1900,1700,0,0,0
3084,Cottonwood Falls,"White ware, Undifferentiated",851,550,1900,1350,0,0,1
3085,Cove,"Chuska Carbon Painted White Ware, Undifferentiated",2,800,1300,500,0,1,1
3085,Cove,"Chuska Corrugated Gray Ware, Undifferentiated",10,890,1300,410,0,0,0
3085,Cove,"Chuska Mineral Painted White Ware, Undifferentiated",6,800,1300,500,0,1,1
3085,Cove,"Chuska Plain Gray Ware, Type Undifferentiated",6,700,925,225,0,0,0
3085,Cove,"Chuska White Ware type, Undifferentiated",2,800,1300,500,0,1,1
3085,Cove,"Cibola Black-on-white, Undifferentiated",16,550,1325,775,0,1,1
3085,Cove,"Indented Corrugated Gray Ware, Undifferentiated",2,950,1400,450,0,0,0
3085,Cove,"Little Colorado White Ware, Undifferentiated",4,825,1250,425,0,1,1
3085,Cove,"Red Ware type, Undifferentiated",2,700,1700,1000,0,0,0
3085,Cove,"Tusayan Corrugated Gray Ware, Undifferentiated",16,865,1285,420,0,0,0
3085,Cove,"Tusayan Gray Ware, Undifferentiated",16,550,1285,735,0,0,0
3085,Cove,"Tusayan White Ware, Undifferentiated",8,825,1300,475,0,1,1
3085,Cove,"White ware, Undifferentiated",4,550,1900,1350,0,0,1
3086,Coyotes Sing Here,Cibola Indented Corrugated Gray,53,1040,1400,360,0,0,0
3086,Coyotes Sing Here,Cibola Neckbanded Gray,4,850,1025,175,0,1,0
3086,Coyotes Sing Here,Cibola Plain Gray,27,550,1040,490,0,0,0
3086,Coyotes Sing Here,"Cibola White Ware, Undifferentiated",25,550,1325,775,0,1,1
3086,Coyotes Sing Here,Escavada-Puerco Black-on-white,24,1000,1100,100,1,1,1
3086,Coyotes Sing Here,Gallup Black-on-white,47,1040,1150,110,1,1,1
3086,Coyotes Sing Here,Puerco Black-on-red,1,1000,1175,175,1,1,1
3086,Coyotes Sing Here,Red Mesa Black-on-white,38,880,1040,160,1,1,1
3086,Coyotes Sing Here,"San Juan Red ware, Undifferentiated",1,700,1050,350,0,0,1
3086,Coyotes Sing Here,Wingate Black-on-red,1,1050,1225,175,1,1,1
3087,CS219,Black Mesa Black-on-white,1,1000,1100,100,1,1,1
3087,CS219,Flagstaff Black-on-white,1,1150,1220,70,1,1,1
3087,CS219,Holbrook A Black-on-white,5,1050,1150,100,1,1,1
3087,CS219,Holbrook B Black-on-white,9,1050,1150,100,1,1,1
3087,CS219,Holbrook Black-on-white,5,1050,1150,100,1,1,1
3087,CS219,Kana-a Black-on-white,3,825,1000,175,1,1,1
3087,CS219,Snowflake or Puerco Black-on-white,1,1030,1300,270,1,1,1
3087,CS219,Sosi Black-on-white,1,1070,1180,110,1,1,1
3087,CS219,Tularosa Black-on-white,1,1180,1300,120,1,1,1
3087,CS219,"Tusayan BMIII/PI White Ware, Type Undifferentiated",1,600,900,300,1,1,1
3087,CS219,Walnut A Black-on-white,12,1100,1250,150,1,1,1
3087,CS219,Walnut B Black-on-white,1,1200,1250,50,1,1,1
3087,CS219,Walnut Black-on-white,2,1100,1250,150,1,1,1
3087,CS219,Walnut/Leupp Black-on-white,1,1100,1250,150,1,1,1
3088,CS689,Black Mesa Black-on-white,6,1000,1100,100,1,1,1
3088,CS689,Black Mesa/Sosi Black-on-white,28,1000,1180,180,1,1,1
3088,CS689,Escavada Black-on-white,6,1000,1100,100,1,1,1
3088,CS689,Gallup Black-on-white,2,1040,1150,110,1,1,1
3088,CS689,Holbrook A Black-on-white,2,1050,1150,100,1,1,1
3088,CS689,Holbrook Black-on-white,44,1050,1150,100,1,1,1
3088,CS689,Holbrook/Walnut Black-on-white,2,1050,1250,200,1,1,1
3088,CS689,Kana-a Black-on-white,16,825,1000,175,1,1,1
3088,CS689,Kiatuthlanna Black-on-white,4,850,925,75,1,1,1
3088,CS689,Padre/Walnut Black-on-white,2,1100,1250,150,1,1,1
3088,CS689,Pinedale Black-on-white,24,1270,1320,50,1,1,1
3088,CS689,Puerco Black-on-white,2,1030,1200,170,1,1,1
3088,CS689,Red Mesa Black-on-white,4,880,1040,160,1,1,1
3088,CS689,Reserve Black-on-white,58,1050,1200,150,1,1,1
3088,CS689,Reserve/Tularosa Black-on-white,2,1050,1300,250,1,1,1
3088,CS689,Snowflake Black-on-white,74,1100,1275,175,1,1,1
3088,CS689,Tularosa/Pinedale Black-on-white,2,1175,1325,150,1,1,1
3088,CS689,Tusayan/Kayenta Black-on-white,2,1200,1300,100,1,1,1
3088,CS689,Walnut A Black-on-white,4,1100,1250,150,1,1,1
3088,CS689,Walnut Black-on-white,8,1100,1250,150,1,1,1
3088,CS689,White Mound Black-on-white,4,700,850,150,1,1,1
3088,CS689,White Mound-Kiatuthlanna Black-on-white,12,700,1040,340,0,1,1
3089,Cuatro Payasos,Blue Shale Corrugated,96,925,1150,225,0,0,0
3089,Cuatro Payasos,Bluff Black-on-red,4,800,925,125,1,1,1
3089,Cuatro Payasos,Brimhall Black-on-white,27,1040,1150,110,1,1,1
3089,Cuatro Payasos,Burnham Black-on-white,2,860,1000,140,1,1,1
3089,Cuatro Payasos,Captain Tom Corrugated,30,890,1000,110,0,1,0
3089,Cuatro Payasos,Chaco Black-on-white,6,1075,1150,75,1,1,1
3089,Cuatro Payasos,Chaco Corrugated,2,1050,1100,50,0,1,0
3089,Cuatro Payasos,Chaco-McElmo Black-on-white (carbon paint),20,1090,1175,85,1,1,1
3089,Cuatro Payasos,Chuska Black-on-white,13,1040,1125,85,1,1,1
3089,Cuatro Payasos,"Chuska Corrugated Gray Ware, Undifferentiated",4,890,1300,410,0,0,0
3089,Cuatro Payasos,"Chuska Gray Ware, Type Undifferentiated",61,700,1300,600,0,0,0
3089,Cuatro Payasos,Chuska Indented Corrugated Gray,34,1040,1300,260,0,0,0
3089,Cuatro Payasos,"Chuska Plain Gray Ware, Type Undifferentiated",26,700,925,225,0,0,0
3089,Cuatro Payasos,"Chuska White Ware type, Undifferentiated",17,800,1300,500,0,1,1
3089,Cuatro Payasos,"Cibola Black-on-white, Undifferentiated",9,550,1325,775,0,1,1
3089,Cuatro Payasos,"Cibola Corrugated Gray Ware, Undifferentiated",3,900,1400,500,0,0,0
3089,Cuatro Payasos,"Cibola Gray Ware, Undifferentiated",14,550,1400,850,0,0,0
3089,Cuatro Payasos,Cibola Indented Corrugated Gray,15,1040,1400,360,0,0,0
3089,Cuatro Payasos,Cibola Neckbanded Gray,19,850,1025,175,0,1,0
3089,Cuatro Payasos,"Cibola PI/PII White Ware, Type Undifferentiated",26,700,1100,400,0,1,1
3089,Cuatro Payasos,"Cibola PII/PIII White Ware, Type Undifferentiated",1,1000,1300,300,1,1,1
3089,Cuatro Payasos,Cibola Plain Gray,33,550,1040,490,0,0,0
3089,Cuatro Payasos,"Cibola White Ware, Undifferentiated",66,550,1325,775,0,1,1
3089,Cuatro Payasos,Coolidge Corrugated,4,1050,1100,50,0,1,0
3089,Cuatro Payasos,Cortez Black-on-white,4,880,1060,180,1,1,1
3089,Cuatro Payasos,Crumbled House Black-on-white,2,1150,1300,150,1,1,1
3089,Cuatro Payasos,Drolet Black-on-white,1,900,1000,100,1,1,1
3089,Cuatro Payasos,Escavada Black-on-white,39,1000,1100,100,1,1,1
3089,Cuatro Payasos,Gallup Black-on-white,78,1040,1150,110,1,1,1
3089,Cuatro Payasos,Gray Hills Banded,14,850,950,100,0,1,0
3089,Cuatro Payasos,Kana'a Gray Ware,6,865,1060,195,0,1,0
3089,Cuatro Payasos,Kiatuthlanna Black-on-white,23,850,925,75,1,1,1
3089,Cuatro Payasos,Mancos Black-on-white,5,980,1180,200,1,1,1
3089,Cuatro Payasos,"Mesa Verde Gray ware, Undifferentiated",1,575,1280,705,0,0,0
3089,Cuatro Payasos,"Mesa Verde PI/PII White Ware, Type Undifferentiated",1,750,1180,430,0,1,1
3089,Cuatro Payasos,Mesa Verde Plain Gray,2,575,1020,445,0,0,0
3089,Cuatro Payasos,Naschitti Black-on-white,1,900,1000,100,1,1,1
3089,Cuatro Payasos,Nava Black-on-white,3,1100,1275,175,1,1,1
3089,Cuatro Payasos,"Neckbanded Gray Ware, Undifferentiated",2,850,1025,175,0,1,0
3089,Cuatro Payasos,Newcomb Black-on-white,3,875,1000,125,1,1,1
3089,Cuatro Payasos,Newcomb Corrugated,10,875,950,75,0,1,0
3089,Cuatro Payasos,"PI/PII White Ware, Type Undifferentiated",8,700,1100,400,0,1,1
3089,Cuatro Payasos,"PII/PIII White Ware, Type Undifferentiated",3,900,1300,400,0,1,1
3089,Cuatro Payasos,Puerco Black-on-red,5,1000,1175,175,1,1,1
3089,Cuatro Payasos,Red Mesa Black-on-white,168,880,1040,160,1,1,1
3089,Cuatro Payasos,Reserve Black-on-white,6,1050,1200,150,1,1,1
3089,Cuatro Payasos,"San Juan Black-on-red, Undifferentiated",1,700,1050,350,0,1,1
3089,Cuatro Payasos,"San Juan Red ware, Undifferentiated",4,700,1050,350,0,0,1
3089,Cuatro Payasos,Sheep Springs Gray,2,800,850,50,0,1,0
3089,Cuatro Payasos,Showlow Red,2,1000,1100,100,0,1,0
3089,Cuatro Payasos,Sosi Black-on-white,3,1070,1180,110,1,1,1
3089,Cuatro Payasos,Taylor Black-on-white,5,1000,1100,100,1,1,1
3089,Cuatro Payasos,Toadlena Black-on-white,13,975,1125,150,1,1,1
3089,Cuatro Payasos,Tocito Gray,12,825,875,50,0,1,0
3089,Cuatro Payasos,Tunicha Black-on-white,1,850,900,50,1,1,1
3089,Cuatro Payasos,Tusayan Black-on-red,1,1045,1240,195,1,1,1
3089,Cuatro Payasos,"White Mountain type, Type Undifferentiated; Early",2,1000,1300,300,0,0,1
3089,Cuatro Payasos,Wingate Black-on-red,1,1050,1225,175,1,1,1
3090,Dalton Pass,Chaco-McElmo Black-on-white (carbon paint),6,1090,1175,85,1,1,1
3090,Dalton Pass,"Chuska Plain Gray Ware, Type Undifferentiated",7,700,925,225,0,0,0
3090,Dalton Pass,"Cibola BMIII/PI White Ware, Type Undifferentiated",4,550,900,350,0,1,1
3090,Dalton Pass,Cibola Clapboard Corrugated Gray,8,900,1100,200,0,1,0
3090,Dalton Pass,Cibola Indented Corrugated Gray,31,1040,1400,360,0,0,0
3090,Dalton Pass,Cibola Narrow Neckbanded,5,900,1025,125,0,1,0
3090,Dalton Pass,Cibola Neckbanded Gray,1,850,1025,175,0,1,0
3090,Dalton Pass,"Cibola PII Gray Ware, Type Undifferentiated",3,950,1100,150,0,1,0
3090,Dalton Pass,"Cibola PII/PIII White Ware, Type Undifferentiated",63,1000,1300,300,1,1,1
3090,Dalton Pass,"Cibola PIII Gray Ware, Type Undifferentiated",2,1100,1300,200,0,1,0
3090,Dalton Pass,"Cibola White Ware, Undifferentiated",8,550,1325,775,0,1,1
3090,Dalton Pass,Cibola Wide Neckbanded,1,850,925,75,0,1,0
3090,Dalton Pass,Escavada Black-on-white,11,1000,1100,100,1,1,1
3090,Dalton Pass,Gallup Black-on-white,11,1040,1150,110,1,1,1
3090,Dalton Pass,Kiatuthlanna Black-on-white,17,850,925,75,1,1,1
3090,Dalton Pass,Puerco Black-on-red,3,1000,1175,175,1,1,1
3090,Dalton Pass,Puerco Black-on-white,5,1030,1200,170,1,1,1
3090,Dalton Pass,Red Mesa Black-on-white,57,880,1040,160,1,1,1
3090,Dalton Pass,Reserve Black-on-white,4,1050,1200,150,1,1,1
3090,Dalton Pass,White Mound Black-on-white,1,700,850,150,1,1,1
3090,Dalton Pass,"White ware, Undifferentiated",1,550,1900,1350,0,0,1
3090,Dalton Pass,Wingate Black-on-red,3,1050,1225,175,1,1,1
3090,Dalton Pass,Wingate Polychrome,1,1100,1225,125,1,1,1
3091,Danson 202,Alma Plain,2,300,1000,700,0,0,0
3091,Danson 202,"Alma series type, Smudged",8,300,1000,700,0,0,0
3091,Danson 202,"Mogollon Corrugated Brown Ware, Undifferentiated",5,800,1400,600,0,0,0
3091,Danson 202,Mogollon Obliterated Corrugated Brown,5,1000,1400,400,0,0,0
3091,Danson 202,Puerco Black-on-red,1,1000,1175,175,1,1,1
3091,Danson 202,Puerco Black-on-white,3,1030,1200,170,1,1,1
3091,Danson 202,"Red Ware type, Undifferentiated",2,700,1700,1000,0,0,0
3091,Danson 202,Reserve Black-on-white,7,1050,1200,150,1,1,1
3091,Danson 202,Tularosa Fillet Rim,3,1100,1350,250,0,0,0
3091,Danson 202,"White ware, Undifferentiated",1,550,1900,1350,0,0,1
3091,Danson 202,Wingate Black-on-red,1,1050,1225,175,1,1,1
3093,Deer Springs,Chaco-McElmo Black-on-white (carbon paint),17,1090,1175,85,1,1,1
3093,Deer Springs,"Chuska Gray Ware, Type Undifferentiated",2,700,1300,600,0,0,0
3093,Deer Springs,Chuska Indented Corrugated Gray,3,1040,1300,260,0,0,0
3093,Deer Springs,"Chuska PII/PIII Black-on-white, Type Undifferentiated",2,900,1300,400,0,1,1
3093,Deer Springs,"Chuska Plain Gray Ware, Type Undifferentiated",50,700,925,225,0,0,0
3093,Deer Springs,"Cibola BMIII/PI White Ware, Type Undifferentiated",1,550,900,350,0,1,1
3093,Deer Springs,Cibola Clapboard Corrugated Gray,16,900,1100,200,0,1,0
3093,Deer Springs,"Cibola Gray Ware, Undifferentiated",3,550,1400,850,0,0,0
3093,Deer Springs,Cibola Indented Corrugated Gray,64,1040,1400,360,0,0,0
3093,Deer Springs,"Cibola PII/PIII Gray Ware, Type Undifferentiated",3,950,1300,350,0,0,0
3093,Deer Springs,"Cibola PII/PIII White Ware, Type Undifferentiated",67,1000,1300,300,1,1,1
3093,Deer Springs,"Cibola White Ware, Undifferentiated",15,550,1325,775,0,1,1
3093,Deer Springs,Crumbled House Black-on-white,1,1150,1300,150,1,1,1
3093,Deer Springs,Deadmans (La Plata) Black-on-red,3,880,1050,170,1,1,1
3093,Deer Springs,Escavada Black-on-white,16,1000,1100,100,1,1,1
3093,Deer Springs,Gallup Black-on-white,20,1040,1150,110,1,1,1
3093,Deer Springs,Kiatuthlanna Black-on-white,5,850,925,75,1,1,1
3093,Deer Springs,La Plata Black-on-white,4,550,750,200,1,1,1
3093,Deer Springs,Lino Gray (Cibola),4,550,950,400,1,0,0
3093,Deer Springs,"Little Colorado White Ware, Undifferentiated",1,825,1250,425,0,1,1
3093,Deer Springs,Mesa Verde Black-on-white,2,1180,1280,100,1,1,1
3093,Deer Springs,"Mesa Verde PII/PIII White Ware, Type Undifferentiated",2,920,1280,360,0,1,1
3093,Deer Springs,Nava Black-on-white,2,1100,1275,175,1,1,1
3093,Deer Springs,Newcomb Black-on-white,1,875,1000,125,1,1,1
3093,Deer Springs,"PII/PIII White Ware, Type Undifferentiated",1,900,1300,400,0,1,1
3093,Deer Springs,"Plain Gray Ware, Undifferentiated",1,500,1300,800,0,0,0
3093,Deer Springs,Puerco Black-on-red,3,1000,1175,175,1,1,1
3093,Deer Springs,Puerco Black-on-white,3,1030,1200,170,1,1,1
3093,Deer Springs,Red Mesa Black-on-white,10,880,1040,160,1,1,1
3093,Deer Springs,"San Juan Red ware, Undifferentiated",2,700,1050,350,0,0,1
3093,Deer Springs,Showlow Red Corrugated,1,1030,1280,250,0,0,0
3093,Deer Springs,Sosi Black-on-white,4,1070,1180,110,1,1,1
3093,Deer Springs,Toadlena Black-on-white,2,975,1125,150,1,1,1
3093,Deer Springs,"Type, Undifferentiated",1,200,1900,1700,0,0,0
3093,Deer Springs,White Mound Black-on-white,11,700,850,150,1,1,1
3093,Deer Springs,"White Mountain type, Type Undifferentiated; Early",7,1000,1300,300,0,0,1
3093,Deer Springs,"White ware, Undifferentiated",5,550,1900,1350,0,0,1
3093,Deer Springs,Wingate Black-on-red,4,1050,1225,175,1,1,1
3093,Deer Springs,Wingate Polychrome,1,1100,1225,125,1,1,1
3096,Dzil Nda Kai,Bennett Gray,2,700,850,150,0,1,0
3096,Dzil Nda Kai,Black Mesa Black-on-white,1,1000,1100,100,1,1,1
3096,Dzil Nda Kai,Chaco Black-on-white,4,1075,1150,75,1,1,1
3096,Dzil Nda Kai,Chuska Indented Corrugated Gray,3,1040,1300,260,0,0,0
3096,Dzil Nda Kai,"Cibola Gray Ware, Undifferentiated",2,550,1400,850,0,0,0
3096,Dzil Nda Kai,Cibola Indented Corrugated Gray,19,1040,1400,360,0,0,0
3096,Dzil Nda Kai,"Cibola White Ware, Undifferentiated",5,550,1325,775,0,1,1
3096,Dzil Nda Kai,Deadmans (La Plata) Black-on-red,1,880,1050,170,1,1,1
3096,Dzil Nda Kai,Escavada Black-on-white,4,1000,1100,100,1,1,1
3096,Dzil Nda Kai,Gallup Black-on-white,14,1040,1150,110,1,1,1
3096,Dzil Nda Kai,La Plata Black-on-white,2,550,750,200,1,1,1
3096,Dzil Nda Kai,Lino Gray (Cibola),7,550,950,400,1,0,0
3096,Dzil Nda Kai,Puerco Black-on-red,1,1000,1175,175,1,1,1
3096,Dzil Nda Kai,Red Mesa Black-on-white,6,880,1040,160,1,1,1
3096,Dzil Nda Kai,"San Juan Red ware, Undifferentiated",3,700,1050,350,0,0,1
3097,Edge of the Cedars,Abajo Red-on-orange,96,760,880,120,1,1,1
3097,Edge of the Cedars,Black Mesa Black-on-white,3,1000,1100,100,1,1,1
3097,Edge of the Cedars,Black Mesa/Sosi Black-on-white,35,1000,1180,180,1,1,1
3097,Edge of the Cedars,Bluff Black-on-red,788,800,925,125,1,1,1
3097,Edge of the Cedars,"Brown Ware, Undifferentiated",1,500,1450,950,0,0,0
3097,Edge of the Cedars,Cameron Polychrome,18,1040,1170,130,1,1,1
3097,Edge of the Cedars,Chaco Black-on-white,4,1075,1150,75,1,1,1
3097,Edge of the Cedars,Chapin Black-on-white,7,575,880,305,0,1,1
3097,Edge of the Cedars,Chapin Gray,26,575,980,405,0,0,0
3097,Edge of the Cedars,"Chuska Gray Ware, Type Undifferentiated",2,700,1300,600,0,0,0
3097,Edge of the Cedars,"Chuska White Ware type, Undifferentiated",4,800,1300,500,0,1,1
3097,Edge of the Cedars,"Cibola White Ware, Undifferentiated",4,550,1325,775,0,1,1
3097,Edge of the Cedars,Citadel Polychrome,30,1040,1200,160,1,1,1
3097,Edge of the Cedars,Citadel/Tusayan Polychrome,1,1040,1320,280,1,1,1
3097,Edge of the Cedars,Cortez Black-on-white,10,880,1060,180,1,1,1
3097,Edge of the Cedars,Deadmans (La Plata) Black-on-red,23,880,1050,170,1,1,1
3097,Edge of the Cedars,Dogoszhi Black-on-white,37,1040,1210,170,1,1,1
3097,Edge of the Cedars,Dolores Corrugated,23,1100,1200,100,0,1,0
3097,Edge of the Cedars,Dolores Red,1,550,900,350,0,0,0
3097,Edge of the Cedars,Escavada Black-on-white,1,1000,1100,100,1,1,1
3097,Edge of the Cedars,Gallup Black-on-white,1,1040,1150,110,1,1,1
3097,Edge of the Cedars,Lino Gray (Tusayan),1,550,950,400,0,0,0
3097,Edge of the Cedars,Mancos Black-on-white,1378,980,1180,200,1,1,1
3097,Edge of the Cedars,Mancos Corrugated,1,920,1180,260,0,0,0
3097,Edge of the Cedars,Mancos Gray,1,880,1060,180,0,1,0
3097,Edge of the Cedars,McElmo Black-on-white,45,1060,1260,200,1,1,1
3097,Edge of the Cedars,Medicine Black-on-red,5,1040,1170,130,1,1,1
3097,Edge of the Cedars,Mesa Verde Black-on-white,2,1180,1280,100,1,1,1
3097,Edge of the Cedars,"Mesa Verde BMIII/PI White Ware, Type Undifferentiated",19,575,920,345,0,1,1
3097,Edge of the Cedars,Mesa Verde Corrugated,2,1100,1280,180,0,1,0
3097,Edge of the Cedars,"Mesa Verde Corrugated Gray Ware, Undifferentiated",6137,920,1280,360,0,0,0
3097,Edge of the Cedars,"Mesa Verde Gray ware, Undifferentiated",62,575,1280,705,0,0,0
3097,Edge of the Cedars,Mesa Verde Neck Corrugated Gray,47,950,1025,75,0,1,0
3097,Edge of the Cedars,Mesa Verde Neckbanded Gray,2819,800,1060,260,0,0,0
3097,Edge of the Cedars,"Mesa Verde PII White Ware, Type Undifferentiated",281,920,1100,180,1,1,1
3097,Edge of the Cedars,"Mesa Verde PII/PIII White Ware, Type Undifferentiated",17,920,1280,360,0,1,1
3097,Edge of the Cedars,Mesa Verde Plain Gray,9647,575,1020,445,0,0,0
3097,Edge of the Cedars,"Mesa Verde White Ware, Undifferentiated",498,575,1280,705,0,1,1
3097,Edge of the Cedars,Moccasin Gray,1,800,980,180,0,1,0
3097,Edge of the Cedars,Mummy Lake Gray,4,1150,1280,130,0,1,0
3097,Edge of the Cedars,Naschitti Black-on-white,1,900,1000,100,1,1,1
3097,Edge of the Cedars,Piedra Black-on-white,16,800,920,120,1,1,1
3097,Edge of the Cedars,"Polychrome, Undifferentiated",1,700,1900,1200,0,1,1
3097,Edge of the Cedars,Puerco Black-on-white,1,1030,1200,170,1,1,1
3097,Edge of the Cedars,Red Mesa Black-on-white,1,880,1040,160,1,1,1
3097,Edge of the Cedars,"Red Ware type, Undifferentiated",6,700,1700,1000,0,0,0
3097,Edge of the Cedars,"San Juan Red ware, Undifferentiated",693,700,1050,350,0,0,1
3097,Edge of the Cedars,Sosi Black-on-white,21,1070,1180,110,1,1,1
3097,Edge of the Cedars,Tallohogan Red,1,620,875,255,0,0,0
3097,Edge of the Cedars,"Tsegi Orange Ware, Undifferentiated",97,1000,1300,300,1,0,1
3097,Edge of the Cedars,Tusayan Black-on-red,45,1045,1240,195,1,1,1
3097,Edge of the Cedars,Tusayan Polychrome,34,1110,1320,210,1,1,1
3097,Edge of the Cedars,"Tusayan White Ware, Undifferentiated",86,825,1300,475,0,1,1
3097,Edge of the Cedars,"Type, Undifferentiated",64,200,1900,1700,0,0,0
3097,Edge of the Cedars,Wetherill Black-on-white,64,1060,1180,120,1,1,1
3097,Edge of the Cedars,"White ware, Undifferentiated",2837,550,1900,1350,0,0,1
3097,Edge of the Cedars,Woodruff Brown,1,500,1100,600,0,0,0
3098,El Malpais,Black Mesa Black-on-white,2,1000,1100,100,1,1,1
3098,El Malpais,Brimhall Black-on-white,1,1040,1150,110,1,1,1
3098,El Malpais,Burnham Black-on-white,2,860,1000,140,1,1,1
3098,El Malpais,Chaco Black-on-white,4,1075,1150,75,1,1,1
3098,El Malpais,Chaco-McElmo Black-on-white (carbon paint),3,1090,1175,85,1,1,1
3098,El Malpais,Chuska Black-on-white,16,1040,1125,85,1,1,1
3098,El Malpais,"Chuska Carbon Painted White Ware, Undifferentiated",24,800,1300,500,0,1,1
3098,El Malpais,Chuska Indented Corrugated Gray,90,1040,1300,260,0,0,0
3098,El Malpais,"Corrugated Gray Ware, Undifferentiated",1,800,1400,600,0,0,0
3098,El Malpais,Crumbled House Black-on-white,1,1150,1300,150,1,1,1
3098,El Malpais,Deadmans (La Plata) Black-on-red,3,880,1050,170,1,1,1
3098,El Malpais,Gallup Black-on-white,1,1040,1150,110,1,1,1
3098,El Malpais,Hunter Corrugated,7,1100,1300,200,0,1,0
3098,El Malpais,"Indented Corrugated Gray Ware, Undifferentiated",402,950,1400,450,0,0,0
3098,El Malpais,Mancos Black-on-white,40,980,1180,200,1,1,1
3098,El Malpais,Mancos Corrugated,2,920,1180,260,0,0,0
3098,El Malpais,McElmo Black-on-white,60,1060,1260,200,1,1,1
3098,El Malpais,McElmo/Mesa Verde Black-on-white,20,1060,1280,220,1,1,1
3098,El Malpais,Mesa Verde Black-on-white,81,1180,1280,100,1,1,1
3098,El Malpais,Mesa Verde Corrugated,26,1100,1280,180,0,1,0
3098,El Malpais,"Mesa Verde Gray ware, Undifferentiated",4,575,1280,705,0,0,0
3098,El Malpais,"Mesa Verde PII/PIII White Ware, Type Undifferentiated",37,920,1280,360,0,1,1
3098,El Malpais,Nava Black-on-white,6,1100,1275,175,1,1,1
3098,El Malpais,Newcomb Black-on-white,2,875,1000,125,1,1,1
3098,El Malpais,"PII Gray Rim, Type Undifferentiated",8,900,1100,200,0,1,0
3098,El Malpais,"PII/PIII Gray Rim, Type Undifferentiated",8,900,1300,400,0,0,0
3098,El Malpais,"PII/PIII White Ware, Type Undifferentiated",5,900,1300,400,0,1,1
3098,El Malpais,"PIII Gray Rim, Type Undifferentiated",6,1100,1300,200,0,1,0
3098,El Malpais,"Plain Gray Ware, Undifferentiated",12,500,1300,800,0,0,0
3098,El Malpais,Puerco Black-on-red,1,1000,1175,175,1,1,1
3098,El Malpais,"San Juan Red ware, Undifferentiated",1,700,1050,350,0,0,1
3098,El Malpais,Sosi/Dogozhi Black-on-white,2,1040,1210,170,1,1,1
3098,El Malpais,Toadlena Black-on-white,13,975,1125,150,1,1,1
3098,El Malpais,"Tsegi Orange Ware, Undifferentiated",12,1000,1300,300,1,0,1
3098,El Malpais,Tunicha Black-on-white,1,850,900,50,1,1,1
3098,El Malpais,Tusayan Black-on-red,3,1045,1240,195,1,1,1
3098,El Malpais,"Type, Undifferentiated",3,200,1900,1700,0,0,0
3098,El Malpais,Wetherill Black-on-white,6,1060,1180,120,1,1,1
3098,El Malpais,"White Mountain type, Type Undifferentiated; Early",2,1000,1300,300,0,0,1
3098,El Malpais,"White ware, Undifferentiated",80,550,1900,1350,0,0,1
3098,El Malpais,Wingate Polychrome,1,1100,1225,125,1,1,1
3099,El Rito,"Cibola BMIII/PI White Ware, Type Undifferentiated",1,550,900,350,0,1,1
3099,El Rito,Cibola Indented Corrugated Gray,4,1040,1400,360,0,0,0
3099,El Rito,"Cibola PII Gray Ware, Type Undifferentiated",1,950,1100,150,0,1,0
3099,El Rito,"Cibola PII/PIII White Ware, Type Undifferentiated",27,1000,1300,300,1,1,1
3099,El Rito,Escavada Black-on-white,6,1000,1100,100,1,1,1
3099,El Rito,Gallup Black-on-white,7,1040,1150,110,1,1,1
3099,El Rito,Kana-a Black-on-white,1,825,1000,175,1,1,1
3099,El Rito,Kiatuthlanna Black-on-white,2,850,925,75,1,1,1
3099,El Rito,Kiet Siel Black-on-red,1,1250,1320,70,1,1,1
3099,El Rito,Mesa Verde Black-on-white,1,1180,1280,100,1,1,1
3099,El Rito,Puerco Black-on-white,1,1030,1200,170,1,1,1
3099,El Rito,Red Mesa Black-on-white,1,880,1040,160,1,1,1
3099,El Rito,Reserve Black-on-white,3,1050,1200,150,1,1,1
3099,El Rito,"Rio Grande Glaze, Undifferentiated",1,1313,1700,387,0,0,1
3099,El Rito,St. Johns Polychrome,2,1200,1300,100,1,1,1
3099,El Rito,Tusayan Black-on-red,1,1045,1240,195,1,1,1
3099,El Rito,"White Mountain type, Type Undifferentiated; Early",2,1000,1300,300,0,0,1
3101,Escalon A,Blue Shale Corrugated,12,925,1150,225,0,0,0
3101,Escalon A,Brimhall Black-on-white,1,1040,1150,110,1,1,1
3101,Escalon A,Burnham Black-on-white,1,860,1000,140,1,1,1
3101,Escalon A,Captain Tom Corrugated,9,890,1000,110,0,1,0
3101,Escalon A,Chaco Black-on-white,1,1075,1150,75,1,1,1
3101,Escalon A,Chaco-McElmo Black-on-white (carbon paint),9,1090,1175,85,1,1,1
3101,Escalon A,Chuska Black-on-white,2,1040,1125,85,1,1,1
3101,Escalon A,"Chuska Clapboard Corrugated Gray, Undifferentiated",8,900,1100,200,0,1,0
3101,Escalon A,"Chuska Gray Ware, Type Undifferentiated",4,700,1300,600,0,0,0
3101,Escalon A,Chuska Indented Corrugated Gray,203,1040,1300,260,0,0,0
3101,Escalon A,"Chuska PII/PIII Black-on-white, Type Undifferentiated",8,900,1300,400,0,1,1
3101,Escalon A,"Chuska Plain Gray Ware, Type Undifferentiated",19,700,925,225,0,0,0
3101,Escalon A,"Chuska White Ware type, Undifferentiated",16,800,1300,500,0,1,1
3101,Escalon A,Cibola Clapboard Corrugated Gray,2,900,1100,200,0,1,0
3101,Escalon A,"Cibola Gray Ware, Undifferentiated",2,550,1400,850,0,0,0
3101,Escalon A,Cibola Indented Corrugated Gray,18,1040,1400,360,0,0,0
3101,Escalon A,"Cibola PII/PIII Gray Ware, Type Undifferentiated",3,950,1300,350,0,0,0
3101,Escalon A,"Cibola PII/PIII White Ware, Type Undifferentiated",50,1000,1300,300,1,1,1
3101,Escalon A,Cibola Plain Gray,9,550,1040,490,0,0,0
3101,Escalon A,"Cibola White Ware, Undifferentiated",84,550,1325,775,0,1,1
3101,Escalon A,Crumbled House Black-on-white,1,1150,1300,150,1,1,1
3101,Escalon A,Escavada Black-on-white,12,1000,1100,100,1,1,1
3101,Escalon A,Gallup Black-on-white,29,1040,1150,110,1,1,1
3101,Escalon A,Hunter Corrugated,3,1100,1300,200,0,1,0
3101,Escalon A,Kiatuthlanna Black-on-white,1,850,925,75,1,1,1
3101,Escalon A,Lino Gray (Cibola),1,550,950,400,1,0,0
3101,Escalon A,Medicine Black-on-red,1,1040,1170,130,1,1,1
3101,Escalon A,Mesa Verde Black-on-white,1,1180,1280,100,1,1,1
3101,Escalon A,Red Mesa Black-on-white,5,880,1040,160,1,1,1
3101,Escalon A,"Red Ware type, Undifferentiated",1,700,1700,1000,0,0,0
3101,Escalon A,"San Juan Red ware, Undifferentiated",1,700,1050,350,0,0,1
3101,Escalon A,Toadlena Black-on-white,6,975,1125,150,1,1,1
3101,Escalon A,"Tsegi Orange Ware, Undifferentiated",1,1000,1300,300,1,0,1
3101,Escalon A,"White ware, Undifferentiated",1,550,1900,1350,0,0,1
3102,Escalon B,Chuska Black-on-white,1,1040,1125,85,1,1,1
3102,Escalon B,Chuska Indented Corrugated Gray,63,1040,1300,260,0,0,0
3102,Escalon B,"Chuska White Ware type, Undifferentiated",1,800,1300,500,0,1,1
3102,Escalon B,Cibola Indented Corrugated Gray,4,1040,1400,360,0,0,0
3102,Escalon B,"Cibola White Ware, Undifferentiated",1,550,1325,775,0,1,1
3102,Escalon B,Dogoszhi Black-on-white,1,1040,1210,170,1,1,1
3102,Escalon B,Escavada Black-on-white,2,1000,1100,100,1,1,1
3102,Escalon B,Gallup Black-on-white,8,1040,1150,110,1,1,1
3102,Escalon B,Red Mesa Black-on-white,1,880,1040,160,1,1,1
3102,Escalon B,Sosi Black-on-white,2,1070,1180,110,1,1,1
3102,Escalon B,Toadlena Black-on-white,1,975,1125,150,1,1,1
3103,Et Al Site,Black Mesa Black-on-white,6,1000,1100,100,1,1,1
3103,Et Al Site,Cameron Polychrome,2,1040,1170,130,1,1,1
3103,Et Al Site,Citadel Polychrome,3,1040,1200,160,1,1,1
3103,Et Al Site,Deadmans (La Plata) Black-on-red,7,880,1050,170,1,1,1
3103,Et Al Site,Dogoszhi Black-on-white,4,1040,1210,170,1,1,1
3103,Et Al Site,Lino Gray (Cibola),2,550,950,400,1,0,0
3103,Et Al Site,Mancos Black-on-white,63,980,1180,200,1,1,1
3103,Et Al Site,McElmo/Mesa Verde Black-on-white,122,1060,1280,220,1,1,1
3103,Et Al Site,Medicine Black-on-red,4,1040,1170,130,1,1,1
3103,Et Al Site,"Mesa Verde Corrugated Gray Ware, Undifferentiated",308,920,1280,360,0,0,0
3103,Et Al Site,"Mesa Verde Gray ware, Undifferentiated",1,575,1280,705,0,0,0
3103,Et Al Site,"Mesa Verde White Ware, Undifferentiated",267,575,1280,705,0,1,1
3103,Et Al Site,"San Juan Black-on-red, Undifferentiated",1,700,1050,350,0,1,1
3103,Et Al Site,"San Juan Red ware, Undifferentiated",14,700,1050,350,0,0,1
3103,Et Al Site,Sosi Black-on-white,18,1070,1180,110,1,1,1
3103,Et Al Site,Tsegi Black-on-orange,2,1225,1300,75,1,1,1
3103,Et Al Site,"Tsegi Orange Ware, Undifferentiated",61,1000,1300,300,1,0,1
3103,Et Al Site,Tusayan Black-on-red,7,1045,1240,195,1,1,1
3103,Et Al Site,Tusayan Polychrome,5,1110,1320,210,1,1,1
3103,Et Al Site,"Tusayan White Ware, Undifferentiated",37,825,1300,475,0,1,1
3103,Et Al Site,Tusayan/Moenkopi Corrugated,198,1020,1320,300,0,0,0
3103,Et Al Site,"White ware, Undifferentiated",10,550,1900,1350,0,0,1
3104,Fajada Gap Great Kiva,Burnham Black-on-white,1,860,1000,140,1,1,1
3104,Fajada Gap Great Kiva,Chaco-McElmo Black-on-white (carbon paint),2,1090,1175,85,1,1,1
3104,Fajada Gap Great Kiva,"Chuska Carbon Painted White Ware, Undifferentiated",6,800,1300,500,0,1,1
3104,Fajada Gap Great Kiva,"Chuska Corrugated Gray Ware, Undifferentiated",4,890,1300,410,0,0,0
3104,Fajada Gap Great Kiva,"Chuska Plain Gray Ware, Type Undifferentiated",3,700,925,225,0,0,0
3104,Fajada Gap Great Kiva,"Cibola Corrugated Gray Ware, Undifferentiated",10,900,1400,500,0,0,0
3104,Fajada Gap Great Kiva,Cibola Narrow Neckbanded,6,900,1025,125,0,1,0
3104,Fajada Gap Great Kiva,Cibola Neck Indented Corrugated,2,950,1025,75,0,1,0
3104,Fajada Gap Great Kiva,Cibola Plain Gray,75,550,1040,490,0,0,0
3104,Fajada Gap Great Kiva,Cibola Wide Neckbanded,1,850,925,75,0,1,0
3104,Fajada Gap Great Kiva,Escavada Black-on-white,2,1000,1100,100,1,1,1
3104,Fajada Gap Great Kiva,Gallup Black-on-white,5,1040,1150,110,1,1,1
3104,Fajada Gap Great Kiva,Gray Hills Banded,2,850,950,100,0,1,0
3104,Fajada Gap Great Kiva,La Plata Black-on-white,1,550,750,200,1,1,1
3104,Fajada Gap Great Kiva,Lino Gray (Cibola),2,550,950,400,1,0,0
3104,Fajada Gap Great Kiva,"PII/PIII White Ware, Type Undifferentiated",22,900,1300,400,0,1,1
3104,Fajada Gap Great Kiva,Puerco Black-on-white,4,1030,1200,170,1,1,1
3104,Fajada Gap Great Kiva,Red Mesa Black-on-white,22,880,1040,160,1,1,1
3104,Fajada Gap Great Kiva,"White ware, Undifferentiated",39,550,1900,1350,0,0,1
3106,Figueredo,Blue Shale Corrugated,4,925,1150,225,0,0,0
3106,Figueredo,Chaco Black-on-white,10,1075,1150,75,1,1,1
3106,Figueredo,Chaco-McElmo Black-on-white (carbon paint),12,1090,1175,85,1,1,1
3106,Figueredo,Chuska Black-on-white,3,1040,1125,85,1,1,1
3106,Figueredo,"Chuska Clapboard Corrugated Gray, Undifferentiated",4,900,1100,200,0,1,0
3106,Figueredo,"Chuska Gray Ware, Type Undifferentiated",3,700,1300,600,0,0,0
3106,Figueredo,Chuska Indented Corrugated Gray,21,1040,1300,260,0,0,0
3106,Figueredo,"Chuska Plain Gray Ware, Type Undifferentiated",1,700,925,225,0,0,0
3106,Figueredo,"Chuska White Ware type, Undifferentiated",2,800,1300,500,0,1,1
3106,Figueredo,"Cibola Black-on-white, Undifferentiated",16,550,1325,775,0,1,1
3106,Figueredo,Cibola Clapboard Corrugated Gray,3,900,1100,200,0,1,0
3106,Figueredo,"Cibola Corrugated Gray Ware, Undifferentiated",5,900,1400,500,0,0,0
3106,Figueredo,Cibola Indented Corrugated Gray,61,1040,1400,360,0,0,0
3106,Figueredo,Cibola Narrow Neckbanded,1,900,1025,125,0,1,0
3106,Figueredo,Cibola Neckbanded Gray,1,850,1025,175,0,1,0
3106,Figueredo,"Cibola PII Gray Ware, Type Undifferentiated",1,950,1100,150,0,1,0
3106,Figueredo,"Cibola PII/PIII White Ware, Type Undifferentiated",32,1000,1300,300,1,1,1
3106,Figueredo,"Cibola PIII Gray Ware, Type Undifferentiated",1,1100,1300,200,0,1,0
3106,Figueredo,Cibola Plain Gray,13,550,1040,490,0,0,0
3106,Figueredo,"Cibola White Ware, Undifferentiated",15,550,1325,775,0,1,1
3106,Figueredo,Deadmans (La Plata) Black-on-red,2,880,1050,170,1,1,1
3106,Figueredo,Escavada Black-on-white,8,1000,1100,100,1,1,1
3106,Figueredo,Gallup Black-on-white,28,1040,1150,110,1,1,1
3106,Figueredo,Gallup or Reserve Black-on-white,3,1040,1200,160,1,1,1
3106,Figueredo,Kana-a Black-on-white,1,825,1000,175,1,1,1
3106,Figueredo,Kiatuthlanna Black-on-white,3,850,925,75,1,1,1
3106,Figueredo,Lino Black-on-gray (Cibola),1,600,850,250,1,1,1
3106,Figueredo,Puerco Black-on-white,8,1030,1200,170,1,1,1
3106,Figueredo,Red Mesa Black-on-white,17,880,1040,160,1,1,1
3106,Figueredo,Reserve Black-on-white,1,1050,1200,150,1,1,1
3106,Figueredo,"San Juan Red ware, Undifferentiated",1,700,1050,350,0,0,1
3106,Figueredo,Sosi Black-on-white,1,1070,1180,110,1,1,1
3106,Figueredo,St. Johns Black-on-red,1,1200,1300,100,1,1,1
3106,Figueredo,St. Johns Polychrome,3,1200,1300,100,1,1,1
3106,Figueredo,Tunicha Black-on-white,1,850,900,50,1,1,1
3106,Figueredo,"Tusayan Gray Ware, Undifferentiated",1,550,1285,735,0,0,0
3106,Figueredo,"White Mountain type, Type Undifferentiated; Early",9,1000,1300,300,0,0,1
3106,Figueredo,Wingate Polychrome,9,1100,1225,125,1,1,1
3107,Fort Defiance--Thunder Ridge,"Indented Corrugated Gray Ware, Undifferentiated",4,950,1400,450,0,0,0
3107,Fort Defiance--Thunder Ridge,McElmo Black-on-white,1,1060,1260,200,1,1,1
3107,Fort Defiance--Thunder Ridge,"Plain Gray Ware, Undifferentiated",3,500,1300,800,0,0,0
3107,Fort Defiance--Thunder Ridge,Puerco Black-on-white,2,1030,1200,170,1,1,1
3107,Fort Defiance--Thunder Ridge,St. Johns Black-on-red or Polychrome,1,1200,1300,100,1,1,1
3107,Fort Defiance--Thunder Ridge,"White ware, Undifferentiated",1,550,1900,1350,0,0,1
3108,Fortified Spur,Abajo Red-on-orange,3,760,880,120,1,1,1
3108,Fortified Spur,Bluff Black-on-red,4,800,925,125,1,1,1
3108,Fortified Spur,Chapin Black-on-white,4,575,880,305,0,1,1
3108,Fortified Spur,Deadmans (La Plata) Black-on-red,9,880,1050,170,1,1,1
3108,Fortified Spur,"Mesa Verde BMIII/PI White Ware, Type Undifferentiated",352,575,920,345,0,1,1
3108,Fortified Spur,Mesa Verde Plain Gray,431,575,1020,445,0,0,0
3108,Fortified Spur,Piedra Black-on-white,2,800,920,120,1,1,1
3108,Fortified Spur,"San Juan Red ware, Undifferentiated",18,700,1050,350,0,0,1
3109,Ganado,Black Mesa Black-on-white,158,1000,1100,100,1,1,1
3109,Ganado,"BMIII/PI White Ware, Type Undifferentiated",14,550,900,350,0,1,1
3109,Ganado,"Chuska Carbon Painted White Ware, Undifferentiated",2,800,1300,500,0,1,1
3109,Ganado,"Corrugated Gray Ware, Undifferentiated",1444,800,1400,600,0,0,0
3109,Ganado,Deadmans (La Plata) Black-on-red,30,880,1050,170,1,1,1
3109,Ganado,Dogoszhi Black-on-white,14,1040,1210,170,1,1,1
3109,Ganado,Gallup Black-on-white,336,1040,1150,110,1,1,1
3109,Ganado,Holbrook Black-on-white,2,1050,1150,100,1,1,1
3109,Ganado,Kana-a Black-on-white,8,825,1000,175,1,1,1
3109,Ganado,Lino Black-on-gray (Cibola),6,600,850,250,1,1,1
3109,Ganado,"Mesa Verde White Ware, Undifferentiated",4,575,1280,705,0,1,1
3109,Ganado,"Narrow Neckbanded Gray Ware, Type Undifferentiated",66,900,1025,125,0,1,0
3109,Ganado,"PII/PIII White Ware, Type Undifferentiated",146,900,1300,400,0,1,1
3109,Ganado,Puerco Black-on-white,54,1030,1200,170,1,1,1
3109,Ganado,Red Mesa Black-on-white,30,880,1040,160,1,1,1
3109,Ganado,"San Juan Red ware, Undifferentiated",10,700,1050,350,0,0,1
3109,Ganado,Tularosa Black-on-white,4,1180,1300,120,1,1,1
3109,Ganado,"Tusayan White Ware, Undifferentiated",10,825,1300,475,0,1,1
3109,Ganado,"Wide Neckbanded Gray Ware, Type Undifferentiated",12,850,925,75,0,1,0
3109,Ganado,Woodruff Smudged,30,500,1100,600,0,0,0
3111,Garcia Ranch Bench,Kana'a Gray Ware,7,865,1060,195,0,1,0
3111,Garcia Ranch Bench,Kiatuthlanna Black-on-white,9,850,925,75,1,1,1
3111,Garcia Ranch Bench,La Plata Black-on-white,1,550,750,200,1,1,1
3111,Garcia Ranch Bench,Lino Gray (Tusayan),29,550,950,400,0,0,0
3111,Garcia Ranch Bench,Moenkopi Corrugated,2,1130,1250,120,0,1,0
3111,Garcia Ranch Bench,Puerco Black-on-white,3,1030,1200,170,1,1,1
3111,Garcia Ranch Bench,Red Mesa Black-on-white,11,880,1040,160,1,1,1
3111,Garcia Ranch Bench,Reserve Black-on-white,2,1050,1200,150,1,1,1
3111,Garcia Ranch Bench,Tularosa Black-on-white,1,1180,1300,120,1,1,1
3111,Garcia Ranch Bench,"Tusayan Corrugated Gray Ware, Undifferentiated",1,865,1285,420,0,0,0
3111,Garcia Ranch Bench,Tusayan Plain Gray,29,600,1300,700,0,0,0
3111,Garcia Ranch Bench,"Type, Undifferentiated",4,200,1900,1700,0,0,0
3111,Garcia Ranch Bench,"White ware, Undifferentiated",12,550,1900,1350,0,0,1
3114,Goodman Point,Cortez Black-on-white,4,880,1060,180,1,1,1
3114,Goodman Point,Deadmans (La Plata) Black-on-red,2,880,1050,170,1,1,1
3114,Goodman Point,Mancos Black-on-white,20,980,1180,200,1,1,1
3114,Goodman Point,Mancos Corrugated,10,920,1180,260,0,0,0
3114,Goodman Point,McElmo Black-on-white,5,1060,1260,200,1,1,1
3114,Goodman Point,Mesa Verde Black-on-white,1,1180,1280,100,1,1,1
3114,Goodman Point,"Mesa Verde BMIII/PI White Ware, Type Undifferentiated",1,575,920,345,0,1,1
3114,Goodman Point,"Mesa Verde Corrugated Gray Ware, Undifferentiated",164,920,1280,360,0,0,0
3114,Goodman Point,"Mesa Verde PII White Ware, Type Undifferentiated",1,920,1100,180,1,1,1
3114,Goodman Point,"Mesa Verde PII/PIII White Ware, Type Undifferentiated",80,920,1280,360,0,1,1
3114,Goodman Point,"Mesa Verde PIII White Ware, Type Undifferentiated",10,1100,1280,180,1,1,1
3114,Goodman Point,Mesa Verde Plain Gray,11,575,1020,445,0,0,0
3114,Goodman Point,Piedra Black-on-white,2,800,920,120,1,1,1
3115,Grass Mesa,Abajo Red-on-orange,355,760,880,120,1,1,1
3115,Grass Mesa,Bennett Gray,2,700,850,150,0,1,0
3115,Grass Mesa,Black Mesa Black-on-white,3,1000,1100,100,1,1,1
3115,Grass Mesa,Bluff Black-on-red,376,800,925,125,1,1,1
3115,Grass Mesa,"Brown Ware, Undifferentiated",1,500,1450,950,0,0,0
3115,Grass Mesa,Chapin Black-on-white,75,575,880,305,0,1,1
3115,Grass Mesa,Chapin Gray,4759,575,980,405,0,0,0
3115,Grass Mesa,"Corrugated Gray Ware, Undifferentiated",1,800,1400,600,0,0,0
3115,Grass Mesa,Cortez Black-on-white,109,880,1060,180,1,1,1
3115,Grass Mesa,Deadmans (La Plata) Black-on-red,179,880,1050,170,1,1,1
3115,Grass Mesa,Drolet Black-on-white,1,900,1000,100,1,1,1
3115,Grass Mesa,Kana-a Black-on-white,17,825,1000,175,1,1,1
3115,Grass Mesa,Mancos Black-on-white,2,980,1180,200,1,1,1
3115,Grass Mesa,Mancos Gray,3261,880,1060,180,0,1,0
3115,Grass Mesa,"Mesa Verde BMIII/PI White Ware, Type Undifferentiated",141,575,920,345,0,1,1
3115,Grass Mesa,"Mesa Verde Corrugated Gray Ware, Undifferentiated",79,920,1280,360,0,0,0
3115,Grass Mesa,"Mesa Verde PII/PIII White Ware, Type Undifferentiated",9,920,1280,360,0,1,1
3115,Grass Mesa,Mesa Verde Plain Gray,107842,575,1020,445,0,0,0
3115,Grass Mesa,Moccasin Gray,11274,800,980,180,0,1,0
3115,Grass Mesa,Naschitti Black-on-white,1,900,1000,100,1,1,1
3115,Grass Mesa,Piedra Black-on-white,426,800,920,120,1,1,1
3115,Grass Mesa,"Plain Brown Smudged, Undifferentiated",11,400,1450,1050,0,0,0
3115,Grass Mesa,Red Mesa Black-on-white,2,880,1040,160,1,1,1
3115,Grass Mesa,"San Juan Red ware, Undifferentiated",5619,700,1050,350,0,0,1
3115,Grass Mesa,Sanostee Black-on-red,1,825,875,50,1,1,1
3115,Grass Mesa,Tallohogan Red,5,620,875,255,0,0,0
3115,Grass Mesa,Theodore Black-on-white,2,800,825,25,1,1,1
3115,Grass Mesa,Tocito Gray,1,825,875,50,0,1,0
3115,Grass Mesa,White Mound Black-on-white,3,700,850,150,1,1,1
3116,Greasewood Flat,Deadmans (La Plata) Black-on-red,2,880,1050,170,1,1,1
3116,Greasewood Flat,McElmo Black-on-white,5,1060,1260,200,1,1,1
3116,Greasewood Flat,Mesa Verde Black-on-white,1,1180,1280,100,1,1,1
3116,Greasewood Flat,Mesa Verde Corrugated,1,1100,1280,180,0,1,0
3116,Greasewood Flat,"Mesa Verde Corrugated Gray Ware, Undifferentiated",20,920,1280,360,0,0,0
3116,Greasewood Flat,"Mesa Verde White Ware, Undifferentiated",25,575,1280,705,0,1,1
3117,Greasy Hill,Chaco Black-on-white,2,1075,1150,75,1,1,1
3117,Greasy Hill,Chaco-McElmo Black-on-white (carbon paint),1,1090,1175,85,1,1,1
3117,Greasy Hill,"Chuska Corrugated Gray Ware, Undifferentiated",1,890,1300,410,0,0,0
3117,Greasy Hill,"Cibola Corrugated Gray Ware, Undifferentiated",43,900,1400,500,0,0,0
3117,Greasy Hill,Cibola Plain Gray,6,550,1040,490,0,0,0
3117,Greasy Hill,"Cibola White Ware, Undifferentiated",3,550,1325,775,0,1,1
3117,Greasy Hill,Escavada Black-on-white,3,1000,1100,100,1,1,1
3117,Greasy Hill,Gallup Black-on-white,23,1040,1150,110,1,1,1
3117,Greasy Hill,Puerco Black-on-red,1,1000,1175,175,1,1,1
3117,Greasy Hill,Red Mesa Black-on-white,1,880,1040,160,1,1,1
3117,Greasy Hill,"White ware, Undifferentiated",2,550,1900,1350,0,0,1
3117,Greasy Hill,Woodruff Smudged,1,500,1100,600,0,0,0
3118,Great Bend House A,Bennett Gray,1,700,850,150,0,1,0
3118,Great Bend House A,Bluff Black-on-red,1,800,925,125,1,1,1
3118,Great Bend House A,Brimhall/Taylor Black-on-white,3,1000,1150,150,1,1,1
3118,Great Bend House A,Burnham Black-on-white,1,860,1000,140,1,1,1
3118,Great Bend House A,Captain Tom Corrugated,24,890,1000,110,0,1,0
3118,Great Bend House A,Chaco-McElmo Black-on-white (carbon paint),3,1090,1175,85,1,1,1
3118,Great Bend House A,Chuska Black-on-white,1,1040,1125,85,1,1,1
3118,Great Bend House A,"Chuska BMIII/PI Black-on-white, Type Undifferentiated",9,700,900,200,1,1,1
3118,Great Bend House A,"Chuska Gray Ware, Type Undifferentiated",8,700,1300,600,0,0,0
3118,Great Bend House A,Chuska Indented Corrugated Gray,34,1040,1300,260,0,0,0
3118,Great Bend House A,"Chuska PI/PII Black-on-white, Type Undifferentiated",14,700,1100,400,0,1,1
3118,Great Bend House A,"Chuska Plain Gray Ware, Type Undifferentiated",105,700,925,225,0,0,0
3118,Great Bend House A,"Chuska White Ware type, Undifferentiated",27,800,1300,500,0,1,1
3118,Great Bend House A,"Cibola Gray Ware, Undifferentiated",1,550,1400,850,0,0,0
3118,Great Bend House A,Cibola Indented Corrugated Gray,3,1040,1400,360,0,0,0
3118,Great Bend House A,"Cibola PI/PII White Ware, Type Undifferentiated",4,700,1100,400,0,1,1
3118,Great Bend House A,"Cibola PII/PIII White Ware, Type Undifferentiated",7,1000,1300,300,1,1,1
3118,Great Bend House A,Cibola Plain Gray,20,550,1040,490,0,0,0
3118,Great Bend House A,Cibola Wide Neckbanded,4,850,925,75,0,1,0
3118,Great Bend House A,Crozier Black-on-white,6,800,900,100,1,1,1
3118,Great Bend House A,Drolet Black-on-white,2,900,1000,100,1,1,1
3118,Great Bend House A,Escavada-Puerco Black-on-white,1,1000,1100,100,1,1,1
3118,Great Bend House A,Gallup Black-on-white,4,1040,1150,110,1,1,1
3118,Great Bend House A,Kana-a Black-on-white,1,825,1000,175,1,1,1
3118,Great Bend House A,Kiatuthlanna Black-on-white,12,850,925,75,1,1,1
3118,Great Bend House A,Lino Gray (Tusayan),1,550,950,400,0,0,0
3118,Great Bend House A,McElmo Black-on-white,3,1060,1260,200,1,1,1
3118,Great Bend House A,Mesa Verde Plain Gray,1,575,1020,445,0,0,0
3118,Great Bend House A,Newcomb Black-on-white,8,875,1000,125,1,1,1
3118,Great Bend House A,Pena Black-on-white,2,800,900,100,1,1,1
3118,Great Bend House A,Red Mesa Black-on-white,14,880,1040,160,1,1,1
3118,Great Bend House A,"San Juan Red ware, Undifferentiated",2,700,1050,350,0,0,1
3118,Great Bend House A,Sheep Springs/Tocito Gray,35,800,875,75,0,1,0
3118,Great Bend House A,Toadlena Black-on-white,1,975,1125,150,1,1,1
3118,Great Bend House A,Tunicha Black-on-white,13,850,900,50,1,1,1
3118,Great Bend House A,White Mound Black-on-white,1,700,850,150,1,1,1
3118,Great Bend House A,"White ware, Undifferentiated",23,550,1900,1350,0,0,1
3119,Great Bend House B,Blue Shale Corrugated,4,925,1150,225,0,0,0
3119,Great Bend House B,Bluff Black-on-red,1,800,925,125,1,1,1
3119,Great Bend House B,Brimhall Black-on-white,1,1040,1150,110,1,1,1
3119,Great Bend House B,Burnham Black-on-white,5,860,1000,140,1,1,1
3119,Great Bend House B,Captain Tom Corrugated,2,890,1000,110,0,1,0
3119,Great Bend House B,Chaco Black-on-white,2,1075,1150,75,1,1,1
3119,Great Bend House B,Chaco-McElmo Black-on-white (carbon paint),2,1090,1175,85,1,1,1
3119,Great Bend House B,Chuska Black-on-white,2,1040,1125,85,1,1,1
3119,Great Bend House B,"Chuska Gray Ware, Type Undifferentiated",4,700,1300,600,0,0,0
3119,Great Bend House B,Chuska Indented Corrugated Gray,73,1040,1300,260,0,0,0
3119,Great Bend House B,Chuska Neckbanded,4,800,950,150,0,1,0
3119,Great Bend House B,"Chuska Plain Gray Ware, Type Undifferentiated",10,700,925,225,0,0,0
3119,Great Bend House B,"Chuska White Ware type, Undifferentiated",3,800,1300,500,0,1,1
3119,Great Bend House B,Cibola Neckbanded Gray,3,850,1025,175,0,1,0
3119,Great Bend House B,Cibola Plain Gray,4,550,1040,490,0,0,0
3119,Great Bend House B,"Cibola White Ware, Undifferentiated",6,550,1325,775,0,1,1
3119,Great Bend House B,"Corrugated Gray Ware, Undifferentiated",1,800,1400,600,0,0,0
3119,Great Bend House B,Deadmans (La Plata) Black-on-red,8,880,1050,170,1,1,1
3119,Great Bend House B,Escavada-Puerco Black-on-white,9,1000,1100,100,1,1,1
3119,Great Bend House B,Gallup Black-on-white,26,1040,1150,110,1,1,1
3119,Great Bend House B,Gray Hills Banded,1,850,950,100,0,1,0
3119,Great Bend House B,Hunter Corrugated,2,1100,1300,200,0,1,0
3119,Great Bend House B,Medicine Black-on-red,1,1040,1170,130,1,1,1
3119,Great Bend House B,Naschitti Black-on-white,4,900,1000,100,1,1,1
3119,Great Bend House B,Newcomb Black-on-white,8,875,1000,125,1,1,1
3119,Great Bend House B,Pena Black-on-white,1,800,900,100,1,1,1
3119,Great Bend House B,Red Mesa Black-on-white,23,880,1040,160,1,1,1
3119,Great Bend House B,Sheep Springs Gray,1,800,850,50,0,1,0
3119,Great Bend House B,Sosi Black-on-white,2,1070,1180,110,1,1,1
3119,Great Bend House B,Toadlena Black-on-white,10,975,1125,150,1,1,1
3119,Great Bend House B,Tunicha Black-on-white,2,850,900,50,1,1,1
3119,Great Bend House B,Tusayan Black-on-red,1,1045,1240,195,1,1,1
3119,Great Bend House B,White Mound Black-on-white,1,700,850,150,1,1,1
3119,Great Bend House B,Wingate Black-on-red,2,1050,1225,175,1,1,1
3120,Great Bend West,Chaco Black-on-white,1,1075,1150,75,1,1,1
3120,Great Bend West,Chuska Black-on-white,1,1040,1125,85,1,1,1
3120,Great Bend West,"Chuska Gray Ware, Type Undifferentiated",1,700,1300,600,0,0,0
3120,Great Bend West,Chuska Indented Corrugated Gray,2,1040,1300,260,0,0,0
3120,Great Bend West,Chuska Neckbanded,4,800,950,150,0,1,0
3120,Great Bend West,"Chuska Plain Gray Ware, Type Undifferentiated",5,700,925,225,0,0,0
3120,Great Bend West,"Cibola Black-on-white, Undifferentiated",8,550,1325,775,0,1,1
3120,Great Bend West,Cibola Indented Corrugated Gray,1,1040,1400,360,0,0,0
3120,Great Bend West,Cibola Plain Gray,1,550,1040,490,0,0,0
3120,Great Bend West,Deadmans (La Plata) Black-on-red,1,880,1050,170,1,1,1
3120,Great Bend West,Escavada Black-on-white,1,1000,1100,100,1,1,1
3120,Great Bend West,Gallup Black-on-white,5,1040,1150,110,1,1,1
3120,Great Bend West,Kiatuthlanna Black-on-white,1,850,925,75,1,1,1
3120,Great Bend West,La Plata Black-on-white,2,550,750,200,1,1,1
3120,Great Bend West,Newcomb Black-on-white,3,875,1000,125,1,1,1
3120,Great Bend West,Red Mesa Black-on-white,13,880,1040,160,1,1,1
3120,Great Bend West,Sosi Black-on-white,1,1070,1180,110,1,1,1
3123,Greenlee,Chaco-McElmo Black-on-white (carbon paint),2,1090,1175,85,1,1,1
3123,Greenlee,Chuska Black-on-white,3,1040,1125,85,1,1,1
3123,Greenlee,Chuska Indented Corrugated Gray,6,1040,1300,260,0,0,0
3123,Greenlee,"Chuska Plain Gray Ware, Type Undifferentiated",1,700,925,225,0,0,0
3123,Greenlee,Cibola Indented Corrugated Gray,150,1040,1400,360,0,0,0
3123,Greenlee,Cibola Neckbanded Gray,22,850,1025,175,0,1,0
3123,Greenlee,Cibola Plain Gray,6,550,1040,490,0,0,0
3123,Greenlee,"Cibola White Ware, Undifferentiated",9,550,1325,775,0,1,1
3123,Greenlee,Cibola Wide Neckbanded,2,850,925,75,0,1,0
3123,Greenlee,Escavada Black-on-white,2,1000,1100,100,1,1,1
3123,Greenlee,Gallup Black-on-white,7,1040,1150,110,1,1,1
3123,Greenlee,McElmo Black-on-white,4,1060,1260,200,1,1,1
3123,Greenlee,Puerco Black-on-red,1,1000,1175,175,1,1,1
3123,Greenlee,Puerco Black-on-white,2,1030,1200,170,1,1,1
3123,Greenlee,Red Mesa Black-on-white,9,880,1040,160,1,1,1
3123,Greenlee,Socorro Black-on-white,2,1050,1300,250,1,1,1
3123,Greenlee,Toadlena Black-on-white,1,975,1125,150,1,1,1
3123,Greenlee,"White Mountain type, Type Undifferentiated; Early",2,1000,1300,300,0,0,1
3123,Greenlee,"White ware, Undifferentiated",29,550,1900,1350,0,0,1
3123,Greenlee,Woodruff Smudged,1,500,1100,600,0,0,0
3124,Grey Hill Spring,Chaco Black-on-white,6,1075,1150,75,1,1,1
3124,Grey Hill Spring,Chaco-McElmo Black-on-white (carbon paint),54,1090,1175,85,1,1,1
3124,Grey Hill Spring,"Chuska Corrugated Gray Ware, Undifferentiated",7,890,1300,410,0,0,0
3124,Grey Hill Spring,Chuska Indented Corrugated Gray,203,1040,1300,260,0,0,0
3124,Grey Hill Spring,"Chuska White Ware type, Undifferentiated",15,800,1300,500,0,1,1
3124,Grey Hill Spring,"Cibola Black-on-white, Undifferentiated",23,550,1325,775,0,1,1
3124,Grey Hill Spring,Cibola Indented Corrugated Gray,129,1040,1400,360,0,0,0
3124,Grey Hill Spring,Cibola Plain Gray,3,550,1040,490,0,0,0
3124,Grey Hill Spring,"Cibola White Ware, Undifferentiated",95,550,1325,775,0,1,1
3124,Grey Hill Spring,Escavada-Puerco Black-on-white,37,1000,1100,100,1,1,1
3124,Grey Hill Spring,Gallup Black-on-white,65,1040,1150,110,1,1,1
3124,Grey Hill Spring,Holbrook B Black-on-white,2,1050,1150,100,1,1,1
3124,Grey Hill Spring,Holbrook Black-on-white,2,1050,1150,100,1,1,1
3124,Grey Hill Spring,"Little Colorado White Ware, Undifferentiated",2,825,1250,425,0,1,1
3124,Grey Hill Spring,Puerco Black-on-red,9,1000,1175,175,1,1,1
3124,Grey Hill Spring,Red Mesa Black-on-white,18,880,1040,160,1,1,1
3124,Grey Hill Spring,Tularosa Black-on-white,3,1180,1300,120,1,1,1
3124,Grey Hill Spring,"Type, Undifferentiated",23,200,1900,1700,0,0,0
3124,Grey Hill Spring,White Mound Black-on-white,6,700,850,150,1,1,1
3124,Grey Hill Spring,"White Mountain type, Type Undifferentiated; Early",3,1000,1300,300,0,0,1
3124,Grey Hill Spring,Wingate Black-on-red,15,1050,1225,175,1,1,1
3125,Grey Ridge,"Brown Ware, Undifferentiated",1,500,1450,950,0,0,0
3125,Grey Ridge,"Chuska Corrugated Gray Ware, Undifferentiated",9,890,1300,410,0,0,0
3125,Grey Ridge,"Cibola Corrugated Gray Ware, Undifferentiated",45,900,1400,500,0,0,0
3125,Grey Ridge,Cibola Narrow Neckbanded,4,900,1025,125,0,1,0
3125,Grey Ridge,Gallup Black-on-white,15,1040,1150,110,1,1,1
3125,Grey Ridge,Springerville Polychrome,1,1250,1300,50,1,1,1
3125,Grey Ridge,Tularosa Black-on-white,2,1180,1300,120,1,1,1
3125,Grey Ridge,"White Mountain type, Type Undifferentiated; Early",49,1000,1300,300,0,0,1
3125,Grey Ridge,"White ware, Undifferentiated",107,550,1900,1350,0,0,1
3126,Guadalupe,Chaco Black-on-white,157,1075,1150,75,1,1,1
3126,Guadalupe,Chaco Corrugated,1861,1050,1100,50,0,1,0
3126,Guadalupe,Cibola Indented Corrugated Gray,4219,1040,1400,360,0,0,0
3126,Guadalupe,Cibola Neckbanded Gray,170,850,1025,175,0,1,0
3126,Guadalupe,Cibola Obliterated Corrugated Gray Ware,7702,1200,1400,200,0,1,0
3126,Guadalupe,Cibola Plain Gray,251,550,1040,490,0,0,0
3126,Guadalupe,"Decorated Type, Undifferentiated",292,300,1900,1600,0,0,1
3126,Guadalupe,Gallup Black-on-white,488,1040,1150,110,1,1,1
3126,Guadalupe,"Gray Ware, Undifferentiated",9,400,1400,1000,0,0,0
3126,Guadalupe,Guadalupe Black-on-white,818,1200,1265,65,1,1,1
3126,Guadalupe,Kwahe-e Black-on-white,179,1125,1200,75,1,1,1
3126,Guadalupe,Mesa Verde Black-on-white,103,1180,1280,100,1,1,1
3126,Guadalupe,"Obliterated Corrugated Gray Ware, Undifferentiated",151,1100,1400,300,0,0,0
3126,Guadalupe,Pinedale Black-on-red,3,1280,1330,50,1,1,1
3126,Guadalupe,Pinedale Polychrome,107,1290,1330,40,1,1,1
3126,Guadalupe,Puerco Black-on-red,4,1000,1175,175,1,1,1
3126,Guadalupe,Puerco Black-on-white,322,1030,1200,170,1,1,1
3126,Guadalupe,Red Mesa Black-on-white,320,880,1040,160,1,1,1
3126,Guadalupe,"Red Ware type, Undifferentiated",116,700,1700,1000,0,0,0
3126,Guadalupe,Santa Fe Black-on-white,1483,1150,1350,200,1,1,1
3126,Guadalupe,Socorro Black-on-white,100,1050,1300,250,1,1,1
3126,Guadalupe,St. Johns Black-on-red,133,1200,1300,100,1,1,1
3126,Guadalupe,St. Johns Polychrome,296,1200,1300,100,1,1,1
3126,Guadalupe,Tularosa Black-on-white,102,1180,1300,120,1,1,1
3126,Guadalupe,Vallecitos Black-on-white,626,1230,1400,170,1,1,1
3126,Guadalupe,Wingate Black-on-red,35,1050,1225,175,1,1,1
3127,H Spear,"Cibola Black-on-white, Undifferentiated",491,550,1325,775,0,1,1
3127,H Spear,"Cibola Corrugated Gray Ware, Undifferentiated",2,900,1400,500,0,0,0
3127,H Spear,Cibola Indented Corrugated Gray,1120,1040,1400,360,0,0,0
3127,H Spear,Cibola Plain Corrugated Gray,11,900,1100,200,0,1,0
3127,H Spear,Cibola Plain Gray,726,550,1040,490,0,0,0
3127,H Spear,Escavada Black-on-white,25,1000,1100,100,1,1,1
3127,H Spear,Gallup Black-on-white,12,1040,1150,110,1,1,1
3127,H Spear,Kiatuthlanna Black-on-white,24,850,925,75,1,1,1
3127,H Spear,Lino Gray (Cibola),120,550,950,400,1,0,0
3127,H Spear,"Mogollon Brown ware, Undifferentiated",15,900,1400,500,0,0,0
3127,H Spear,"Mogollon Corrugated Brown Ware, Undifferentiated",55,800,1400,600,0,0,0
3127,H Spear,Mogollon Plain Corrugated Brown Ware,3,900,1400,500,0,0,0
3127,H Spear,Puerco Black-on-red,3,1000,1175,175,1,1,1
3127,H Spear,Puerco Black-on-white,35,1030,1200,170,1,1,1
3127,H Spear,Red Mesa Black-on-white,11,880,1040,160,1,1,1
3127,H Spear,Reserve Black-on-white,42,1050,1200,150,1,1,1
3127,H Spear,Tularosa Black-on-white,18,1180,1300,120,1,1,1
3127,H Spear,"Type, Undifferentiated",5,200,1900,1700,0,0,0
3127,H Spear,"White Mountain type, Type Undifferentiated; Early",73,1000,1300,300,0,0,1
3127,H Spear,Wingate Black-on-red,9,1050,1225,175,1,1,1
3128,Halfway House,Chaco Black-on-white,2,1075,1150,75,1,1,1
3128,Halfway House,"Chuska Corrugated Gray Ware, Undifferentiated",4,890,1300,410,0,0,0
3128,Halfway House,"Chuska Gray Ware, Type Undifferentiated",95,700,1300,600,0,0,0
3128,Halfway House,Cibola Indented Corrugated Gray,54,1040,1400,360,0,0,0
3128,Halfway House,Cibola Plain Gray,1,550,1040,490,0,0,0
3128,Halfway House,"Cibola White Ware, Undifferentiated",14,550,1325,775,0,1,1
3128,Halfway House,Escavada Black-on-white,4,1000,1100,100,1,1,1
3128,Halfway House,Gallup Black-on-white,3,1040,1150,110,1,1,1
3128,Halfway House,McElmo Black-on-white,15,1060,1260,200,1,1,1
3129,Hammond Canyon,Abajo Red-on-orange,2,760,880,120,1,1,1
3129,Hammond Canyon,Bluff Black-on-red,4,800,925,125,1,1,1
3129,Hammond Canyon,Chapin Gray,3,575,980,405,0,0,0
3129,Hammond Canyon,Deadmans (La Plata) Black-on-red,1,880,1050,170,1,1,1
3129,Hammond Canyon,Mancos Black-on-white,8,980,1180,200,1,1,1
3129,Hammond Canyon,Mancos Gray,14,880,1060,180,0,1,0
3129,Hammond Canyon,Mesa Verde Black-on-white,2,1180,1280,100,1,1,1
3129,Hammond Canyon,"Mesa Verde Corrugated Gray Ware, Undifferentiated",12,920,1280,360,0,0,0
3129,Hammond Canyon,Moccasin Gray,17,800,980,180,0,1,0
3129,Hammond Canyon,"Plain Gray Ware, Undifferentiated",86,500,1300,800,0,0,0
3129,Hammond Canyon,"White ware, Undifferentiated",10,550,1900,1350,0,0,1
3130,Hampton,Bluff Black-on-red,1,800,925,125,1,1,1
3130,Hampton,Chuska Black-on-white,1,1040,1125,85,1,1,1
3130,Hampton,Cortez Black-on-white,3,880,1060,180,1,1,1
3130,Hampton,Deadmans (La Plata) Black-on-red,3,880,1050,170,1,1,1
3130,Hampton,Dolores Corrugated,1,1100,1200,100,0,1,0
3130,Hampton,Mancos Black-on-white,25,980,1180,200,1,1,1
3130,Hampton,Mancos Corrugated,2,920,1180,260,0,0,0
3130,Hampton,Mancos Gray,7,880,1060,180,0,1,0
3130,Hampton,McElmo Black-on-white,39,1060,1260,200,1,1,1
3130,Hampton,Mesa Verde Black-on-white,44,1180,1280,100,1,1,1
3130,Hampton,"Mesa Verde BMIII/PI White Ware, Type Undifferentiated",18,575,920,345,0,1,1
3130,Hampton,Mesa Verde Corrugated,3,1100,1280,180,0,1,0
3130,Hampton,"Mesa Verde Corrugated Gray Ware, Undifferentiated",232,920,1280,360,0,0,0
3130,Hampton,"Mesa Verde PII White Ware, Type Undifferentiated",17,920,1100,180,1,1,1
3130,Hampton,"Mesa Verde PII/PIII White Ware, Type Undifferentiated",130,920,1280,360,0,1,1
3130,Hampton,"Mesa Verde PIII White Ware, Type Undifferentiated",44,1100,1280,180,1,1,1
3130,Hampton,Mesa Verde Plain Gray,63,575,1020,445,0,0,0
3130,Hampton,Moccasin Gray,2,800,980,180,0,1,0
3130,Hampton,Piedra Black-on-white,3,800,920,120,1,1,1
3130,Hampton,"San Juan Red ware, Undifferentiated",2,700,1050,350,0,0,1
3131,Hartman Draw,Abajo Red-on-orange,2,760,880,120,1,1,1
3131,Hartman Draw,Bluff Black-on-red,2,800,925,125,1,1,1
3131,Hartman Draw,Cortez Black-on-white,4,880,1060,180,1,1,1
3131,Hartman Draw,Deadmans (La Plata) Black-on-red,9,880,1050,170,1,1,1
3131,Hartman Draw,Dolores Corrugated,2,1100,1200,100,0,1,0
3131,Hartman Draw,Mancos Black-on-white,24,980,1180,200,1,1,1
3131,Hartman Draw,Mancos Corrugated,2,920,1180,260,0,0,0
3131,Hartman Draw,Mancos Gray,10,880,1060,180,0,1,0
3131,Hartman Draw,McElmo Black-on-white,6,1060,1260,200,1,1,1
3131,Hartman Draw,"Mesa Verde BMIII/PI White Ware, Type Undifferentiated",1,575,920,345,0,1,1
3131,Hartman Draw,"Mesa Verde Corrugated Gray Ware, Undifferentiated",107,920,1280,360,0,0,0
3131,Hartman Draw,"Mesa Verde PII White Ware, Type Undifferentiated",19,920,1100,180,1,1,1
3131,Hartman Draw,"Mesa Verde PII/PIII White Ware, Type Undifferentiated",125,920,1280,360,0,1,1
3131,Hartman Draw,"Mesa Verde PIII White Ware, Type Undifferentiated",10,1100,1280,180,1,1,1
3131,Hartman Draw,Mesa Verde Plain Gray,58,575,1020,445,0,0,0
3131,Hartman Draw,Moccasin Gray,8,800,980,180,0,1,0
3131,Hartman Draw,Piedra Black-on-white,15,800,920,120,1,1,1
3131,Hartman Draw,"San Juan Red ware, Undifferentiated",9,700,1050,350,0,0,1
3133,Haynie Ruin,Bluff Black-on-red,5,800,925,125,1,1,1
3133,Haynie Ruin,Chapin Gray,1,575,980,405,0,0,0
3133,Haynie Ruin,Cortez Black-on-white,47,880,1060,180,1,1,1
3133,Haynie Ruin,Deadmans (La Plata) Black-on-red,26,880,1050,170,1,1,1
3133,Haynie Ruin,Dolores Corrugated,8,1100,1200,100,0,1,0
3133,Haynie Ruin,Mancos Black-on-white,129,980,1180,200,1,1,1
3133,Haynie Ruin,Mancos Corrugated,37,920,1180,260,0,0,0
3133,Haynie Ruin,Mancos Gray,50,880,1060,180,0,1,0
3133,Haynie Ruin,McElmo Black-on-white,28,1060,1260,200,1,1,1
3133,Haynie Ruin,Mesa Verde Black-on-white,17,1180,1280,100,1,1,1
3133,Haynie Ruin,"Mesa Verde BMIII/PI White Ware, Type Undifferentiated",30,575,920,345,0,1,1
3133,Haynie Ruin,Mesa Verde Corrugated,18,1100,1280,180,0,1,0
3133,Haynie Ruin,"Mesa Verde Corrugated Gray Ware, Undifferentiated",651,920,1280,360,0,0,0
3133,Haynie Ruin,"Mesa Verde PII White Ware, Type Undifferentiated",71,920,1100,180,1,1,1
3133,Haynie Ruin,"Mesa Verde PII/PIII White Ware, Type Undifferentiated",511,920,1280,360,0,1,1
3133,Haynie Ruin,"Mesa Verde PIII White Ware, Type Undifferentiated",144,1100,1280,180,1,1,1
3133,Haynie Ruin,Mesa Verde Plain Gray,377,575,1020,445,0,0,0
3133,Haynie Ruin,Moccasin Gray,51,800,980,180,0,1,0
3133,Haynie Ruin,Piedra Black-on-white,10,800,920,120,1,1,1
3133,Haynie Ruin,"San Juan Red ware, Undifferentiated",6,700,1050,350,0,0,1
3134,Haystack,Cebolleta Black-on-white,1,1000,1200,200,1,1,1
3134,Haystack,"Chuska Carbon Painted White Ware, Undifferentiated",1,800,1300,500,0,1,1
3134,Haystack,Cibola Clapboard Corrugated Gray,1,900,1100,200,0,1,0
3134,Haystack,Cibola Indented Corrugated Gray,66,1040,1400,360,0,0,0
3134,Haystack,Cibola Neckbanded Gray,4,850,1025,175,0,1,0
3134,Haystack,"Cibola PII/PIII White Ware, Type Undifferentiated",9,1000,1300,300,1,1,1
3134,Haystack,Cibola Plain Gray,8,550,1040,490,0,0,0
3134,Haystack,"Cibola White Ware, Undifferentiated",7,550,1325,775,0,1,1
3134,Haystack,Escavada Black-on-white,4,1000,1100,100,1,1,1
3134,Haystack,Escavada-Puerco Black-on-white,21,1000,1100,100,1,1,1
3134,Haystack,Gallup Black-on-white,41,1040,1150,110,1,1,1
3134,Haystack,Kana-a Black-on-white,1,825,1000,175,1,1,1
3134,Haystack,Lino Gray (Cibola),1,550,950,400,1,0,0
3134,Haystack,Medicine Black-on-red,1,1040,1170,130,1,1,1
3134,Haystack,"Mogollon Plain Brown Ware, Smudged",5,300,1400,1100,0,0,0
3134,Haystack,"PII/PIII Gray Rim, Type Undifferentiated",1,900,1300,400,0,0,0
3134,Haystack,Pilares Ribbed Banded,3,1050,1150,100,0,1,0
3134,Haystack,"Plain Gray Ware, Undifferentiated",5,500,1300,800,0,0,0
3134,Haystack,Puerco Black-on-red,6,1000,1175,175,1,1,1
3134,Haystack,Puerco Black-on-white,1,1030,1200,170,1,1,1
3134,Haystack,Red Mesa Black-on-white,3,880,1040,160,1,1,1
3134,Haystack,"Red Ware type, Undifferentiated",3,700,1700,1000,0,0,0
3134,Haystack,Socorro Black-on-white,7,1050,1300,250,1,1,1
3134,Haystack,"White Mountain type, Type Undifferentiated; Early",1,1000,1300,300,0,0,1
3134,Haystack,"White ware, Undifferentiated",2,550,1900,1350,0,0,1
3135,Hedley Ruin,Abajo Red-on-orange,8,760,880,120,1,1,1
3135,Hedley Ruin,Bluff Black-on-red,16,800,925,125,1,1,1
3135,Hedley Ruin,Chapin Black-on-white,3,575,880,305,0,1,1
3135,Hedley Ruin,Chapin Gray,13,575,980,405,0,0,0
3135,Hedley Ruin,Cortez Black-on-white,6,880,1060,180,1,1,1
3135,Hedley Ruin,Deadmans (La Plata) Black-on-red,15,880,1050,170,1,1,1
3135,Hedley Ruin,Mancos Black-on-white,760,980,1180,200,1,1,1
3135,Hedley Ruin,Mancos Corrugated,51,920,1180,260,0,0,0
3135,Hedley Ruin,Mancos Gray,42,880,1060,180,0,1,0
3135,Hedley Ruin,McElmo Black-on-white,289,1060,1260,200,1,1,1
3135,Hedley Ruin,Mesa Verde Black-on-white,321,1180,1280,100,1,1,1
3135,Hedley Ruin,Mesa Verde Corrugated,96,1100,1280,180,0,1,0
3135,Hedley Ruin,"Mesa Verde Gray ware, Undifferentiated",6352,575,1280,705,0,0,0
3135,Hedley Ruin,"Mesa Verde PII White Ware, Type Undifferentiated",22,920,1100,180,1,1,1
3135,Hedley Ruin,"Mesa Verde PII/PIII White Ware, Type Undifferentiated",3753,920,1280,360,0,1,1
3135,Hedley Ruin,"Mesa Verde PIII White Ware, Type Undifferentiated",1276,1100,1280,180,1,1,1
3135,Hedley Ruin,"Mesa Verde White Ware, Undifferentiated",20,575,1280,705,0,1,1
3135,Hedley Ruin,Moccasin Gray,34,800,980,180,0,1,0
3135,Hedley Ruin,"Mudware, Undifferentiated",3,400,1400,1000,0,0,0
3135,Hedley Ruin,"Neckbanded Gray Ware, Undifferentiated",5,850,1025,175,0,1,0
3135,Hedley Ruin,Piedra Black-on-white,4,800,920,120,1,1,1
3135,Hedley Ruin,"Plain Gray Ware, Undifferentiated",1,500,1300,800,0,0,0
3135,Hedley Ruin,"Polychrome, Undifferentiated",2,700,1900,1200,0,1,1
3135,Hedley Ruin,"Red Ware type, Undifferentiated",48,700,1700,1000,0,0,0
3135,Hedley Ruin,"Type, Undifferentiated",10,200,1900,1700,0,0,0
3135,Hedley Ruin,"White ware, Undifferentiated",113,550,1900,1350,0,0,1
3136,Hogback,Black Mesa Black-on-white,1,1000,1100,100,1,1,1
3136,Hogback,Bluff Black-on-red,2,800,925,125,1,1,1
3136,Hogback,Brimhall Black-on-white,1,1040,1150,110,1,1,1
3136,Hogback,Burnham Black-on-white,19,860,1000,140,1,1,1
3136,Hogback,Chaco-McElmo Black-on-white (carbon paint),1,1090,1175,85,1,1,1
3136,Hogback,Chuska Black-on-white,3,1040,1125,85,1,1,1
3136,Hogback,"Chuska Carbon Painted White Ware, Undifferentiated",23,800,1300,500,0,1,1
3136,Hogback,"Chuska Gray Ware, Type Undifferentiated",12,700,1300,600,0,0,0
3136,Hogback,Chuska Indented Corrugated Gray,163,1040,1300,260,0,0,0
3136,Hogback,Chuska Neck Indented Corrugated Gray,16,950,1025,75,0,1,0
3136,Hogback,"Chuska PII Gray, Type Undifferentiated",1,1040,1100,60,0,1,0
3136,Hogback,"Chuska Plain Gray Ware, Type Undifferentiated",124,700,925,225,0,0,0
3136,Hogback,"Chuska White Ware type, Undifferentiated",45,800,1300,500,0,1,1
3136,Hogback,"Cibola Black-on-white, Undifferentiated",20,550,1325,775,0,1,1
3136,Hogback,"Cibola Gray Ware, Undifferentiated",4,550,1400,850,0,0,0
3136,Hogback,Cibola Indented Corrugated Gray,49,1040,1400,360,0,0,0
3136,Hogback,Cibola Narrow Neckbanded,9,900,1025,125,0,1,0
3136,Hogback,Cibola Neck Indented Corrugated,2,950,1025,75,0,1,0
3136,Hogback,"Cibola PII Gray Ware, Type Undifferentiated",1,950,1100,150,0,1,0
3136,Hogback,Cibola Plain Gray,52,550,1040,490,0,0,0
3136,Hogback,Cibola Wide Neckbanded,3,850,925,75,0,1,0
3136,Hogback,Deadmans (La Plata) Black-on-red,7,880,1050,170,1,1,1
3136,Hogback,Drolet Black-on-white,3,900,1000,100,1,1,1
3136,Hogback,Escavada-Puerco Black-on-white,2,1000,1100,100,1,1,1
3136,Hogback,Gallup Black-on-white,14,1040,1150,110,1,1,1
3136,Hogback,Gray Hills Banded,75,850,950,100,0,1,0
3136,Hogback,Kana-a Black-on-white,2,825,1000,175,1,1,1
3136,Hogback,Kiatuthlanna Black-on-white,10,850,925,75,1,1,1
3136,Hogback,Lino Gray (trachyte),1,550,950,400,0,0,0
3136,Hogback,Mancos Black-on-white,2,980,1180,200,1,1,1
3136,Hogback,McElmo Black-on-white,4,1060,1260,200,1,1,1
3136,Hogback,"Mesa Verde Corrugated Gray Ware, Undifferentiated",5,920,1280,360,0,0,0
3136,Hogback,Naschitti Black-on-white,4,900,1000,100,1,1,1
3136,Hogback,Newcomb Black-on-white,44,875,1000,125,1,1,1
3136,Hogback,Pena Black-on-white,3,800,900,100,1,1,1
3136,Hogback,"PII/PIII White Ware, Type Undifferentiated",3,900,1300,400,0,1,1
3136,Hogback,Puerco Black-on-white,1,1030,1200,170,1,1,1
3136,Hogback,Red Mesa Black-on-white,38,880,1040,160,1,1,1
3136,Hogback,"San Juan Red ware, Undifferentiated",4,700,1050,350,0,0,1
3136,Hogback,Sheep Springs Gray,7,800,850,50,0,1,0
3136,Hogback,Toadlena Black-on-white,4,975,1125,150,1,1,1
3136,Hogback,Tunicha Black-on-white,5,850,900,50,1,1,1
3136,Hogback,"Tusayan White Ware, Undifferentiated",1,825,1300,475,0,1,1
3136,Hogback,"White ware, Undifferentiated",73,550,1900,1350,0,0,1
3136,Hogback,Woodruff Smudged,1,500,1100,600,0,0,0
3138,Houck,Black Mesa Black-on-white,24,1000,1100,100,1,1,1
3138,Houck,Chaco Black-on-white,1,1075,1150,75,1,1,1
3138,Houck,"Cibola White Ware, Undifferentiated",154,550,1325,775,0,1,1
3138,Houck,"Corrugated Gray Ware, Undifferentiated",42,800,1400,600,0,0,0
3138,Houck,"Decorated Type, Undifferentiated",2,300,1900,1600,0,0,1
3138,Houck,Gallup Black-on-white,133,1040,1150,110,1,1,1
3138,Houck,"Indented Corrugated Gray Ware, Undifferentiated",960,950,1400,450,0,0,0
3138,Houck,Kana-a Black-on-white,3,825,1000,175,1,1,1
3138,Houck,Kintiel Black-on-orange,3,1275,1300,25,1,1,1
3138,Houck,Klagetoh Black-on-white,9,1250,1300,50,1,1,1
3138,Houck,Lino Gray (Cibola),19,550,950,400,1,0,0
3138,Houck,Moenkopi Corrugated,2,1130,1250,120,0,1,0
3138,Houck,"Mogollon Brown ware, Undifferentiated",20,900,1400,500,0,0,0
3138,Houck,Mogollon Plain Brown Ware,2,300,1400,1100,0,0,0
3138,Houck,"Mogollon Plain Brown Ware, Smudged",77,300,1400,1100,0,0,0
3138,Houck,"Obliterated Corrugated Gray Ware, Undifferentiated",1,1100,1400,300,0,0,0
3138,Houck,Pinto/Gila Polychrome,2,1300,1450,150,1,1,1
3138,Houck,"Plain Gray Ware, Undifferentiated",32,500,1300,800,0,0,0
3138,Houck,Puerco Black-on-red,56,1000,1175,175,1,1,1
3138,Houck,Puerco Black-on-white,372,1030,1200,170,1,1,1
3138,Houck,Red Mesa Black-on-white,32,880,1040,160,1,1,1
3138,Houck,St. Johns Polychrome,39,1200,1300,100,1,1,1
3138,Houck,Tularosa Black-on-white,6,1180,1300,120,1,1,1
3138,Houck,"Tusayan Gray Ware, Undifferentiated",24,550,1285,735,0,0,0
3138,Houck,"Tusayan White Ware, Undifferentiated",4,825,1300,475,0,1,1
3138,Houck,"Type, Undifferentiated",3,200,1900,1700,0,0,0
3138,Houck,Walnut Black-on-white,27,1100,1250,150,1,1,1
3138,Houck,White Mound Black-on-white,5,700,850,150,1,1,1
3138,Houck,"White Mountain type, Type Undifferentiated; Early",25,1000,1300,300,0,0,1
3138,Houck,"White ware, Undifferentiated",4,550,1900,1350,0,0,1
3138,Houck,Wingate Black-on-red,37,1050,1225,175,1,1,1
3138,Houck,Wingate Polychrome,39,1100,1225,125,1,1,1
3138,Houck,Woodruff Red,6,400,1100,700,0,0,0
3139,Hough's Great Kiva,"Alameda Brown Ware, Type Undifferentiated",6,700,1400,700,0,0,0
3139,Hough's Great Kiva,Aquarius Orange,23,1000,1100,100,0,1,0
3139,Hough's Great Kiva,Black Mesa Black-on-white,9,1000,1100,100,1,1,1
3139,Hough's Great Kiva,"Cibola BMIII/PI White Ware, Type Undifferentiated",2,550,900,350,0,1,1
3139,Hough's Great Kiva,"Cibola Gray Ware, Undifferentiated",63,550,1400,850,0,0,0
3139,Hough's Great Kiva,"Cibola PII/PIII White Ware, Type Undifferentiated",882,1000,1300,300,1,1,1
3139,Hough's Great Kiva,"Cibola PIII/PIV White Ware, Type Undifferentiated",2,1200,1325,125,1,1,1
3139,Hough's Great Kiva,"Cibola White Ware, Undifferentiated",1143,550,1325,775,0,1,1
3139,Hough's Great Kiva,Dogoszhi Black-on-white,2,1040,1210,170,1,1,1
3139,Hough's Great Kiva,Escavada Black-on-white,48,1000,1100,100,1,1,1
3139,Hough's Great Kiva,Gallup Black-on-white,12,1040,1150,110,1,1,1
3139,Hough's Great Kiva,Gila Butte/Santa Cruz/Sacaton Red-on-buff,1,750,1150,400,0,1,1
3139,Hough's Great Kiva,Holbrook A Black-on-white,3,1050,1150,100,1,1,1
3139,Hough's Great Kiva,Holbrook B Black-on-white,5,1050,1150,100,1,1,1
3139,Hough's Great Kiva,Kiatuthlanna Black-on-white,5,850,925,75,1,1,1
3139,Hough's Great Kiva,Kirkland Gray,1,800,1400,600,0,0,0
3139,Hough's Great Kiva,"Little Colorado Corrugated Gray Ware, Undifferentiated",9,1050,1250,200,0,1,0
3139,Hough's Great Kiva,"Little Colorado Plain Gray, Undifferentiated",2,550,1040,490,0,0,0
3139,Hough's Great Kiva,"Little Colorado White Ware, Undifferentiated",27,825,1250,425,0,1,1
3139,Hough's Great Kiva,McDonald Corrugated,2,1150,1280,130,1,1,1
3139,Hough's Great Kiva,"Mogollon Brown ware, Undifferentiated",588,900,1400,500,0,0,0
3139,Hough's Great Kiva,"Mogollon Corrugated Brown Ware, Undifferentiated",227,800,1400,600,0,0,0
3139,Hough's Great Kiva,Mogollon Indented Corrugated Brown Ware,3774,1000,1400,400,0,0,0
3139,Hough's Great Kiva,"Mogollon Indented Corrugated Brown Ware, Smudged",66,1000,1400,400,0,0,0
3139,Hough's Great Kiva,Mogollon Obliterated Corrugated Brown,12,1000,1400,400,0,0,0
3139,Hough's Great Kiva,Mogollon Patterned Corrugated Brown Ware,73,1000,1400,400,0,0,0
3139,Hough's Great Kiva,Mogollon Plain Brown Ware,1309,300,1400,1100,0,0,0
3139,Hough's Great Kiva,"Mogollon Plain Brown Ware, Smudged",132,300,1400,1100,0,0,0
3139,Hough's Great Kiva,Mogollon Zoned Corrugated Brown Ware,66,1000,1400,400,0,0,0
3139,Hough's Great Kiva,"Mogollon Zoned Corrugated Brown Ware, Smudged",6,1000,1400,400,0,0,0
3139,Hough's Great Kiva,"Neck Indented Corrugated Gray Ware, Type Undifferentiated",1,950,1025,75,0,1,0
3139,Hough's Great Kiva,Pinedale Black-on-white,1,1270,1320,50,1,1,1
3139,Hough's Great Kiva,"Prescott Gray Ware, Undifferentiated",1,1025,1200,175,0,1,0
3139,Hough's Great Kiva,Puerco Black-on-red,1,1000,1175,175,1,1,1
3139,Hough's Great Kiva,Puerco Black-on-white,24,1030,1200,170,1,1,1
3139,Hough's Great Kiva,"Puerco Valley Red Ware, Undifferentiated",174,1000,1200,200,0,1,0
3139,Hough's Great Kiva,Red Mesa Black-on-white,53,880,1040,160,1,1,1
3139,Hough's Great Kiva,"Red Ware type, Undifferentiated",2,700,1700,1000,0,0,0
3139,Hough's Great Kiva,Reserve Black-on-white,101,1050,1200,150,1,1,1
3139,Hough's Great Kiva,Reserve/Tularosa Black-on-white,10,1050,1300,250,1,1,1
3139,Hough's Great Kiva,"San Francisco Mountain Gray, Undifferentiated",1,700,1100,400,0,0,0
3139,Hough's Great Kiva,Showlow Black-on-red,14,1030,1200,170,1,1,1
3139,Hough's Great Kiva,Showlow Black-on-red Corrugated,2,1050,1200,150,1,1,1
3139,Hough's Great Kiva,Showlow Red,116,1000,1100,100,0,1,0
3139,Hough's Great Kiva,Showlow Red Corrugated,116,1030,1280,250,0,0,0
3139,Hough's Great Kiva,Snowflake Black-on-white,111,1100,1275,175,1,1,1
3139,Hough's Great Kiva,Sosi Black-on-white,5,1070,1180,110,1,1,1
3139,Hough's Great Kiva,Tularosa Black-on-white,2,1180,1300,120,1,1,1
3139,Hough's Great Kiva,Tularosa/Pinedale Black-on-white,12,1175,1325,150,1,1,1
3139,Hough's Great Kiva,"Tusayan Gray Ware, Undifferentiated",1,550,1285,735,0,0,0
3139,Hough's Great Kiva,"Tusayan White Ware, Undifferentiated",143,825,1300,475,0,1,1
3139,Hough's Great Kiva,Verde Gray,1,1100,1300,200,0,1,0
3139,Hough's Great Kiva,"White Mountain type, Type Undifferentiated; Early",6,1000,1300,300,0,0,1
3139,Hough's Great Kiva,Woodruff Brown,126,500,1100,600,0,0,0
3139,Hough's Great Kiva,Woodruff Smudged,251,500,1100,600,0,0,0
3140,House Creek,Abajo Red-on-orange,1,760,880,120,1,1,1
3140,House Creek,Bluff Black-on-red,290,800,925,125,1,1,1
3140,House Creek,Chapin Black-on-white,49,575,880,305,0,1,1
3140,House Creek,Chapin Gray,331,575,980,405,0,0,0
3140,House Creek,Mancos Gray,106,880,1060,180,0,1,0
3140,House Creek,"Mesa Verde BMIII/PI White Ware, Type Undifferentiated",1,575,920,345,0,1,1
3140,House Creek,"Mesa Verde Corrugated Gray Ware, Undifferentiated",1,920,1280,360,0,0,0
3140,House Creek,Mesa Verde Plain Gray,9430,575,1020,445,0,0,0
3140,House Creek,Moccasin Gray,1011,800,980,180,0,1,0
3140,House Creek,Piedra Black-on-white,23,800,920,120,1,1,1
3140,House Creek,"San Juan Red ware, Undifferentiated",130,700,1050,350,0,0,1
3141,House of the Giant Midden,Black Mesa/Sosi Black-on-white,2,1000,1180,180,1,1,1
3141,House of the Giant Midden,Bluff Black-on-red,6,800,925,125,1,1,1
3141,House of the Giant Midden,"BMIII/PI White Ware, Type Undifferentiated",2,550,900,350,0,1,1
3141,House of the Giant Midden,"Chuska Carbon Painted White Ware, Undifferentiated",28,800,1300,500,0,1,1
3141,House of the Giant Midden,"Chuska Gray Ware, Type Undifferentiated",12,700,1300,600,0,0,0
3141,House of the Giant Midden,Chuska Indented Corrugated Gray,14,1040,1300,260,0,0,0
3141,House of the Giant Midden,"Chuska Mineral Painted White Ware, Undifferentiated",4,800,1300,500,0,1,1
3141,House of the Giant Midden,Chuska Neck Indented Corrugated Gray,6,950,1025,75,0,1,0
3141,House of the Giant Midden,"Chuska PII Gray, Type Undifferentiated",2,1040,1100,60,0,1,0
3141,House of the Giant Midden,"Chuska Plain Gray Ware, Type Undifferentiated",270,700,925,225,0,0,0
3141,House of the Giant Midden,"Chuska White Ware type, Undifferentiated",66,800,1300,500,0,1,1
3141,House of the Giant Midden,"Cibola BMIII/PI White Ware, Type Undifferentiated",6,550,900,350,0,1,1
3141,House of the Giant Midden,"Cibola Gray Ware, Undifferentiated",2,550,1400,850,0,0,0
3141,House of the Giant Midden,Cibola Indented Corrugated Gray,8,1040,1400,360,0,0,0
3141,House of the Giant Midden,Cibola Narrow Neckbanded,10,900,1025,125,0,1,0
3141,House of the Giant Midden,Cibola Plain Gray,222,550,1040,490,0,0,0
3141,House of the Giant Midden,Cibola Wide Neckbanded,20,850,925,75,0,1,0
3141,House of the Giant Midden,Crozier Black-on-white,8,800,900,100,1,1,1
3141,House of the Giant Midden,Drolet Black-on-white,4,900,1000,100,1,1,1
3141,House of the Giant Midden,Gallup Black-on-white,4,1040,1150,110,1,1,1
3141,House of the Giant Midden,Gray Hills Banded,24,850,950,100,0,1,0
3141,House of the Giant Midden,Kana-a Black-on-white,6,825,1000,175,1,1,1
3141,House of the Giant Midden,Kiatuthlanna Black-on-white,36,850,925,75,1,1,1
3141,House of the Giant Midden,Lino Gray (Cibola),6,550,950,400,1,0,0
3141,House of the Giant Midden,Lino Gray (trachyte),4,550,950,400,0,0,0
3141,House of the Giant Midden,Newcomb Black-on-white,10,875,1000,125,1,1,1
3141,House of the Giant Midden,"PII/PIII White Ware, Type Undifferentiated",24,900,1300,400,0,1,1
3141,House of the Giant Midden,Puerco Black-on-red,4,1000,1175,175,1,1,1
3141,House of the Giant Midden,Red Mesa Black-on-white,18,880,1040,160,1,1,1
3141,House of the Giant Midden,"San Juan Red ware, Undifferentiated",8,700,1050,350,0,0,1
3141,House of the Giant Midden,Sanostee Black-on-red,6,825,875,50,1,1,1
3141,House of the Giant Midden,Sheep Springs Gray,42,800,850,50,0,1,0
3141,House of the Giant Midden,Tunicha Black-on-white,8,850,900,50,1,1,1
3141,House of the Giant Midden,White Mound Black-on-white,10,700,850,150,1,1,1
3141,House of the Giant Midden,"White Mountain type, Type Undifferentiated; Early",4,1000,1300,300,0,0,1
3141,House of the Giant Midden,"White ware, Undifferentiated",126,550,1900,1350,0,0,1
3144,Hurley Site,"Cibola Corrugated Gray Ware, Undifferentiated",1,900,1400,500,0,0,0
3144,Hurley Site,Cibola Indented Corrugated Gray,48,1040,1400,360,0,0,0
3144,Hurley Site,Cibola Neckbanded Gray,5,850,1025,175,0,1,0
3144,Hurley Site,Cibola Plain Gray,45,550,1040,490,0,0,0
3144,Hurley Site,Escavada-Puerco Black-on-white,4,1000,1100,100,1,1,1
3144,Hurley Site,Gallup Black-on-white,7,1040,1150,110,1,1,1
3144,Hurley Site,Red Mesa Black-on-white,14,880,1040,160,1,1,1
3144,Hurley Site,Socorro Black-on-white,1,1050,1300,250,1,1,1
3144,Hurley Site,White Mound Black-on-white,1,700,850,150,1,1,1
3145,Ida Jean,Abajo Red-on-orange,4,760,880,120,1,1,1
3145,Ida Jean,Bluff Black-on-red,1,800,925,125,1,1,1
3145,Ida Jean,Chapin Black-on-white,6,575,880,305,0,1,1
3145,Ida Jean,Chapin Gray,5,575,980,405,0,0,0
3145,Ida Jean,Cortez Black-on-white,1,880,1060,180,1,1,1
3145,Ida Jean,Deadmans (La Plata) Black-on-red,6,880,1050,170,1,1,1
3145,Ida Jean,Dolores Corrugated,41,1100,1200,100,0,1,0
3145,Ida Jean,Mancos Black-on-white,161,980,1180,200,1,1,1
3145,Ida Jean,Mancos Corrugated,7,920,1180,260,0,0,0
3145,Ida Jean,Mancos Gray,11,880,1060,180,0,1,0
3145,Ida Jean,McElmo Black-on-white,321,1060,1260,200,1,1,1
3145,Ida Jean,Mesa Verde Black-on-white,581,1180,1280,100,1,1,1
3145,Ida Jean,Mesa Verde Corrugated,115,1100,1280,180,0,1,0
3145,Ida Jean,"Mesa Verde Corrugated Gray Ware, Undifferentiated",7299,920,1280,360,0,0,0
3145,Ida Jean,"Mesa Verde PII/PIII White Ware, Type Undifferentiated",2968,920,1280,360,0,1,1
3145,Ida Jean,Mesa Verde Plain Gray,884,575,1020,445,0,0,0
3145,Ida Jean,"San Juan Red ware, Undifferentiated",13,700,1050,350,0,0,1
3146,Iyanbito Great Kiva,"Chuska Plain Gray Ware, Type Undifferentiated",1,700,925,225,0,0,0
3146,Iyanbito Great Kiva,Cibola Clapboard Corrugated Gray,2,900,1100,200,0,1,0
3146,Iyanbito Great Kiva,Cibola Indented Corrugated Gray,27,1040,1400,360,0,0,0
3146,Iyanbito Great Kiva,"Cibola PII/PIII White Ware, Type Undifferentiated",25,1000,1300,300,1,1,1
3146,Iyanbito Great Kiva,"Cibola White Ware, Undifferentiated",4,550,1325,775,0,1,1
3146,Iyanbito Great Kiva,Escavada Black-on-white,14,1000,1100,100,1,1,1
3146,Iyanbito Great Kiva,Gallup Black-on-white,6,1040,1150,110,1,1,1
3146,Iyanbito Great Kiva,Kiatuthlanna Black-on-white,1,850,925,75,1,1,1
3146,Iyanbito Great Kiva,Puerco Black-on-red,10,1000,1175,175,1,1,1
3146,Iyanbito Great Kiva,Red Mesa Black-on-white,6,880,1040,160,1,1,1
3146,Iyanbito Great Kiva,Reserve Black-on-white,4,1050,1200,150,1,1,1
3146,Iyanbito Great Kiva,"Type, Undifferentiated",1,200,1900,1700,0,0,0
3146,Iyanbito Great Kiva,"White Mountain type, Type Undifferentiated; Early",2,1000,1300,300,0,0,1
3147,Kearn's Site,Abajo Red-on-orange,3,760,880,120,1,1,1
3147,Kearn's Site,Bluff Black-on-red,5,800,925,125,1,1,1
3147,Kearn's Site,Chapin Black-on-white,3,575,880,305,0,1,1
3147,Kearn's Site,Chapin Gray,5,575,980,405,0,0,0
3147,Kearn's Site,Cortez Black-on-white,6,880,1060,180,1,1,1
3147,Kearn's Site,Deadmans (La Plata) Black-on-red,5,880,1050,170,1,1,1
3147,Kearn's Site,Dolores Corrugated,6,1100,1200,100,0,1,0
3147,Kearn's Site,Mancos Black-on-white,31,980,1180,200,1,1,1
3147,Kearn's Site,Mancos Corrugated,6,920,1180,260,0,0,0
3147,Kearn's Site,Mancos Gray,12,880,1060,180,0,1,0
3147,Kearn's Site,McElmo Black-on-white,46,1060,1260,200,1,1,1
3147,Kearn's Site,Mesa Verde Black-on-white,42,1180,1280,100,1,1,1
3147,Kearn's Site,"Mesa Verde BMIII/PI White Ware, Type Undifferentiated",51,575,920,345,0,1,1
3147,Kearn's Site,Mesa Verde Corrugated,21,1100,1280,180,0,1,0
3147,Kearn's Site,"Mesa Verde Corrugated Gray Ware, Undifferentiated",453,920,1280,360,0,0,0
3147,Kearn's Site,"Mesa Verde PII White Ware, Type Undifferentiated",22,920,1100,180,1,1,1
3147,Kearn's Site,"Mesa Verde PII/PIII White Ware, Type Undifferentiated",273,920,1280,360,0,1,1
3147,Kearn's Site,"Mesa Verde PIII White Ware, Type Undifferentiated",27,1100,1280,180,1,1,1
3147,Kearn's Site,Mesa Verde Plain Gray,89,575,1020,445,0,0,0
3147,Kearn's Site,Moccasin Gray,4,800,980,180,0,1,0
3147,Kearn's Site,Piedra Black-on-white,14,800,920,120,1,1,1
3147,Kearn's Site,"San Juan Red ware, Undifferentiated",8,700,1050,350,0,0,1
3149,Kin Bineola,Black Mesa Black-on-white,1,1000,1100,100,1,1,1
3149,Kin Bineola,Black Mesa/Sosi Black-on-white,15,1000,1180,180,1,1,1
3149,Kin Bineola,Bluff Black-on-red,3,800,925,125,1,1,1
3149,Kin Bineola,"BMIII/PI White Ware, Type Undifferentiated",44,550,900,350,0,1,1
3149,Kin Bineola,Chaco Black-on-white,10,1075,1150,75,1,1,1
3149,Kin Bineola,Chaco-McElmo Black-on-white (carbon paint),42,1090,1175,85,1,1,1
3149,Kin Bineola,Chuska Black-on-white,14,1040,1125,85,1,1,1
3149,Kin Bineola,"Chuska Carbon Painted White Ware, Undifferentiated",13,800,1300,500,0,1,1
3149,Kin Bineola,"Chuska Corrugated Gray Ware, Undifferentiated",124,890,1300,410,0,0,0
3149,Kin Bineola,Chuska Indented Corrugated Gray,19,1040,1300,260,0,0,0
3149,Kin Bineola,Chuska Narrow Neckbanded,14,825,950,125,0,1,0
3149,Kin Bineola,Chuska Neck Indented Corrugated Gray,3,950,1025,75,0,1,0
3149,Kin Bineola,Chuska Neckbanded,5,800,950,150,0,1,0
3149,Kin Bineola,"Chuska PII Gray, Type Undifferentiated",10,1040,1100,60,0,1,0
3149,Kin Bineola,"Chuska PII/PIII Gray, Type Undifferentiated",1,1040,1300,260,0,0,0
3149,Kin Bineola,"Chuska Plain Gray Ware, Type Undifferentiated",96,700,925,225,0,0,0
3149,Kin Bineola,"Chuska White Ware type, Undifferentiated",19,800,1300,500,0,1,1
3149,Kin Bineola,"Cibola Black-on-white, Undifferentiated",298,550,1325,775,0,1,1
3149,Kin Bineola,"Cibola BMIII/PI White Ware, Type Undifferentiated",9,550,900,350,0,1,1
3149,Kin Bineola,"Cibola Corrugated Gray Ware, Undifferentiated",217,900,1400,500,0,0,0
3149,Kin Bineola,Cibola Indented Corrugated Gray,71,1040,1400,360,0,0,0
3149,Kin Bineola,Cibola Narrow Neckbanded,33,900,1025,125,0,1,0
3149,Kin Bineola,Cibola Neck Indented Corrugated,6,950,1025,75,0,1,0
3149,Kin Bineola,Cibola Neckbanded Gray,15,850,1025,175,0,1,0
3149,Kin Bineola,"Cibola PII Gray Ware, Type Undifferentiated",6,950,1100,150,0,1,0
3149,Kin Bineola,"Cibola PII/PIII Gray Ware, Type Undifferentiated",1,950,1300,350,0,0,0
3149,Kin Bineola,Cibola Plain Gray,627,550,1040,490,0,0,0
3149,Kin Bineola,"Cibola White Ware, Undifferentiated",432,550,1325,775,0,1,1
3149,Kin Bineola,Cibola Wide Neckbanded,4,850,925,75,0,1,0
3149,Kin Bineola,"Corrugated Gray Ware, Undifferentiated",254,800,1400,600,0,0,0
3149,Kin Bineola,Crozier Black-on-white,4,800,900,100,1,1,1
3149,Kin Bineola,Escavada Black-on-white,22,1000,1100,100,1,1,1
3149,Kin Bineola,Escavada-Puerco Black-on-white,7,1000,1100,100,1,1,1
3149,Kin Bineola,Gallup Black-on-white,47,1040,1150,110,1,1,1
3149,Kin Bineola,Holbrook Black-on-white,2,1050,1150,100,1,1,1
3149,Kin Bineola,"Indented Corrugated Gray Ware, Undifferentiated",368,950,1400,450,0,0,0
3149,Kin Bineola,Kana-a Black-on-white,24,825,1000,175,1,1,1
3149,Kin Bineola,Kiatuthlanna-Red Mesa Black-on-white,12,850,1040,190,1,1,1
3149,Kin Bineola,La Plata Black-on-white,1,550,750,200,1,1,1
3149,Kin Bineola,Lino Black-on-gray (Cibola),1,600,850,250,1,1,1
3149,Kin Bineola,Lino Gray (Cibola),16,550,950,400,1,0,0
3149,Kin Bineola,Lino Gray (trachyte),1,550,950,400,0,0,0
3149,Kin Bineola,Lino Gray Fugitive Red [Cibola Series],27,550,850,300,1,0,0
3149,Kin Bineola,McElmo Black-on-white,5,1060,1260,200,1,1,1
3149,Kin Bineola,"Narrow Neckbanded Gray Ware, Type Undifferentiated",233,900,1025,125,0,1,0
3149,Kin Bineola,"Neck Indented Corrugated Gray Ware, Type Undifferentiated",28,950,1025,75,0,1,0
3149,Kin Bineola,Newcomb Black-on-white,2,875,1000,125,1,1,1
3149,Kin Bineola,Newcomb or Burnham Black-on-white,4,860,1000,140,1,1,1
3149,Kin Bineola,Pena Black-on-white,11,800,900,100,1,1,1
3149,Kin Bineola,"PII Gray Rim, Type Undifferentiated",8,900,1100,200,0,1,0
3149,Kin Bineola,"PII/PIII Gray Rim, Type Undifferentiated",11,900,1300,400,0,0,0
3149,Kin Bineola,"PII/PIII White Ware, Type Undifferentiated",281,900,1300,400,0,1,1
3149,Kin Bineola,"PIII Gray Rim, Type Undifferentiated",5,1100,1300,200,0,1,0
3149,Kin Bineola,"Plain Gray Ware, Undifferentiated",1055,500,1300,800,0,0,0
3149,Kin Bineola,Puerco Black-on-red,5,1000,1175,175,1,1,1
3149,Kin Bineola,Puerco Black-on-white,35,1030,1200,170,1,1,1
3149,Kin Bineola,Red Mesa Black-on-white,196,880,1040,160,1,1,1
3149,Kin Bineola,"San Juan Red ware, Undifferentiated",30,700,1050,350,0,0,1
3149,Kin Bineola,Sanostee Black-on-red,5,825,875,50,1,1,1
3149,Kin Bineola,Toadlena Black-on-white,4,975,1125,150,1,1,1
3149,Kin Bineola,Tunicha Black-on-white,19,850,900,50,1,1,1
3149,Kin Bineola,Tusayan Black-on-white,2,1200,1300,100,1,1,1
3149,Kin Bineola,"Tusayan White Ware, Undifferentiated",18,825,1300,475,0,1,1
3149,Kin Bineola,White Mound Black-on-white,8,700,850,150,1,1,1
3149,Kin Bineola,"White Mountain type, Type Undifferentiated; Early",5,1000,1300,300,0,0,1
3149,Kin Bineola,"White ware, Undifferentiated",238,550,1900,1350,0,0,1
3149,Kin Bineola,"Wide Neckbanded Gray Ware, Type Undifferentiated",100,850,925,75,0,1,0
3149,Kin Bineola,Wingate Black-on-red,2,1050,1225,175,1,1,1
3149,Kin Bineola,Woodruff Smudged,17,500,1100,600,0,0,0
3150,Kin Cheops I,Alma Plain,3,300,1000,700,0,0,0
3150,Kin Cheops I,"Cibola Black-on-white, Undifferentiated",52,550,1325,775,0,1,1
3150,Kin Cheops I,"Cibola BMIII/PI White Ware, Type Undifferentiated",1,550,900,350,0,1,1
3150,Kin Cheops I,Cibola Clapboard Corrugated Gray,20,900,1100,200,0,1,0
3150,Kin Cheops I,"Cibola Corrugated Gray Ware, Undifferentiated",21,900,1400,500,0,0,0
3150,Kin Cheops I,"Cibola Gray Ware, Undifferentiated",9,550,1400,850,0,0,0
3150,Kin Cheops I,Cibola Indented Corrugated Gray,326,1040,1400,360,0,0,0
3150,Kin Cheops I,Cibola Plain Gray,54,550,1040,490,0,0,0
3150,Kin Cheops I,"Cibola White Ware, Undifferentiated",106,550,1325,775,0,1,1
3150,Kin Cheops I,Escavada Black-on-white,3,1000,1100,100,1,1,1
3150,Kin Cheops I,Gallup Black-on-white,6,1040,1150,110,1,1,1
3150,Kin Cheops I,Kana'a Neckbanded,2,865,1060,195,0,1,0
3150,Kin Cheops I,Kiatuthlanna Black-on-white,2,850,925,75,1,1,1
3150,Kin Cheops I,Klagetoh Black-on-white,4,1250,1300,50,1,1,1
3150,Kin Cheops I,Lino Gray (Cibola),5,550,950,400,1,0,0
3150,Kin Cheops I,Mogollon Indented Corrugated Brown Ware,81,1000,1400,400,0,0,0
3150,Kin Cheops I,Mogollon Patterned Corrugated Brown Ware,13,1000,1400,400,0,0,0
3150,Kin Cheops I,Mogollon Plain Brown Ware,78,300,1400,1100,0,0,0
3150,Kin Cheops I,Mogollon Plain Corrugated Brown Ware,54,900,1400,500,0,0,0
3150,Kin Cheops I,"Mogollon Plain Corrugated Brown Ware, Smudged",9,900,1400,500,0,0,0
3150,Kin Cheops I,Puerco Black-on-red,37,1000,1175,175,1,1,1
3150,Kin Cheops I,Puerco Black-on-white,64,1030,1200,170,1,1,1
3150,Kin Cheops I,"Puerco Valley Gray Ware, Undifferentiated",10,400,1300,900,0,0,0
3150,Kin Cheops I,Red Mesa Black-on-white,11,880,1040,160,1,1,1
3150,Kin Cheops I,"Red Ware type, Undifferentiated",8,700,1700,1000,0,0,0
3150,Kin Cheops I,Reserve Black-on-white,171,1050,1200,150,1,1,1
3150,Kin Cheops I,Reserve/Tularosa Black-on-white,113,1050,1300,250,1,1,1
3150,Kin Cheops I,Socorro Black-on-white,8,1050,1300,250,1,1,1
3150,Kin Cheops I,Tularosa Black-on-white,14,1180,1300,120,1,1,1
3150,Kin Cheops I,"White Mountain type, Type Undifferentiated; Early",41,1000,1300,300,0,0,1
3150,Kin Cheops I,Wingate Black-on-red,50,1050,1225,175,1,1,1
3150,Kin Cheops I,Wingate Polychrome,3,1100,1225,125,1,1,1
3152,Kin Hochoi,"Black-on-gray, Undifferentiated",2,550,1300,750,0,1,1
3152,Kin Hochoi,Burnham Black-on-white,1,860,1000,140,1,1,1
3152,Kin Hochoi,Chaco Black-on-white,1,1075,1150,75,1,1,1
3152,Kin Hochoi,Chuska Indented Corrugated Gray,1,1040,1300,260,0,0,0
3152,Kin Hochoi,"Cibola Black-on-white, Undifferentiated",116,550,1325,775,0,1,1
3152,Kin Hochoi,Cibola Clapboard Corrugated Gray,9,900,1100,200,0,1,0
3152,Kin Hochoi,Cibola Indented Corrugated Gray,357,1040,1400,360,0,0,0
3152,Kin Hochoi,Cibola Narrow Neckbanded,1,900,1025,125,0,1,0
3152,Kin Hochoi,Cibola Neckbanded Gray,1,850,1025,175,0,1,0
3152,Kin Hochoi,"Cibola PII Gray Ware, Type Undifferentiated",1,950,1100,150,0,1,0
3152,Kin Hochoi,"Cibola PII/PIII Gray Ware, Type Undifferentiated",1,950,1300,350,0,0,0
3152,Kin Hochoi,"Cibola PII/PIII White Ware, Type Undifferentiated",22,1000,1300,300,1,1,1
3152,Kin Hochoi,"Cibola PIII Gray Ware, Type Undifferentiated",1,1100,1300,200,0,1,0
3152,Kin Hochoi,Cibola Plain Corrugated Gray,5,900,1100,200,0,1,0
3152,Kin Hochoi,Cibola Plain Gray,186,550,1040,490,0,0,0
3152,Kin Hochoi,Escavada Black-on-white,53,1000,1100,100,1,1,1
3152,Kin Hochoi,Flagstaff Black-on-white,1,1150,1220,70,1,1,1
3152,Kin Hochoi,Gallup Black-on-white,46,1040,1150,110,1,1,1
3152,Kin Hochoi,Kiatuthlanna Black-on-white,2,850,925,75,1,1,1
3152,Kin Hochoi,Puerco Black-on-red,3,1000,1175,175,1,1,1
3152,Kin Hochoi,Puerco Black-on-white,17,1030,1200,170,1,1,1
3152,Kin Hochoi,Red Mesa Black-on-white,8,880,1040,160,1,1,1
3152,Kin Hochoi,Reserve Black-on-white,12,1050,1200,150,1,1,1
3152,Kin Hochoi,Snowflake Black-on-white,3,1100,1275,175,1,1,1
3152,Kin Hochoi,Sosi Black-on-white,1,1070,1180,110,1,1,1
3152,Kin Hochoi,St. Johns Black-on-red,2,1200,1300,100,1,1,1
3152,Kin Hochoi,St. Johns Polychrome,5,1200,1300,100,1,1,1
3152,Kin Hochoi,Tularosa Black-on-white,6,1180,1300,120,1,1,1
3152,Kin Hochoi,"White Mountain type, Type Undifferentiated; Early",11,1000,1300,300,0,0,1
3152,Kin Hochoi,"White ware, Undifferentiated",51,550,1900,1350,0,0,1
3152,Kin Hochoi,Wingate Black-on-red,8,1050,1225,175,1,1,1
3152,Kin Hochoi,Wingate Polychrome,1,1100,1225,125,1,1,1
3153,Kin Indian Ruin,Chaco Black-on-white,1,1075,1150,75,1,1,1
3153,Kin Indian Ruin,"Chuska Corrugated Gray Ware, Undifferentiated",4,890,1300,410,0,0,0
3153,Kin Indian Ruin,Chuska Indented Corrugated Gray,20,1040,1300,260,0,0,0
3153,Kin Indian Ruin,"Chuska Plain Gray Ware, Type Undifferentiated",4,700,925,225,0,0,0
3153,Kin Indian Ruin,"Chuska White Ware type, Undifferentiated",1,800,1300,500,0,1,1
3153,Kin Indian Ruin,"Cibola Corrugated Gray Ware, Undifferentiated",11,900,1400,500,0,0,0
3153,Kin Indian Ruin,Cibola Indented Corrugated Gray,46,1040,1400,360,0,0,0
3153,Kin Indian Ruin,Cibola Neckbanded Gray,3,850,1025,175,0,1,0
3153,Kin Indian Ruin,Cibola Plain Gray,18,550,1040,490,0,0,0
3153,Kin Indian Ruin,"Cibola White Ware, Undifferentiated",27,550,1325,775,0,1,1
3153,Kin Indian Ruin,Escavada Black-on-white,4,1000,1100,100,1,1,1
3153,Kin Indian Ruin,Gallup Black-on-white,20,1040,1150,110,1,1,1
3153,Kin Indian Ruin,McElmo Black-on-white,6,1060,1260,200,1,1,1
3153,Kin Indian Ruin,"White Mountain type, Type Undifferentiated; Early",1,1000,1300,300,0,0,1
3154,Kin Kletso,"Black-on-red, Undifferentiated",14,700,1700,1000,0,1,1
3154,Kin Kletso,Chaco Black-on-white,704,1075,1150,75,1,1,1
3154,Kin Kletso,Chaco-McElmo Black-on-white (carbon paint),3054,1090,1175,85,1,1,1
3154,Kin Kletso,Citadel Polychrome,100,1040,1200,160,1,1,1
3154,Kin Kletso,Escavada Black-on-white,1153,1000,1100,100,1,1,1
3154,Kin Kletso,Gallup Black-on-white,314,1040,1150,110,1,1,1
3154,Kin Kletso,Mancos Black-on-white,75,980,1180,200,1,1,1
3154,Kin Kletso,"Mogollon Plain Corrugated Brown Ware, Smudged",24,900,1400,500,0,0,0
3154,Kin Kletso,Puerco Black-on-red,70,1000,1175,175,1,1,1
3154,Kin Kletso,Red Mesa Black-on-white,15,880,1040,160,1,1,1
3154,Kin Kletso,Tularosa Fillet Rim,5,1100,1350,250,0,0,0
3154,Kin Kletso,Tusayan Black-on-red,119,1045,1240,195,1,1,1
3154,Kin Kletso,Wingate Black-on-red,202,1050,1225,175,1,1,1
3154,Kin Kletso,Woodruff Red Smudged,212,400,1100,700,0,0,0
3155,Kin Klizhin,Black Mesa/Sosi Black-on-white,2,1000,1180,180,1,1,1
3155,Kin Klizhin,Chaco Black-on-white,3,1075,1150,75,1,1,1
3155,Kin Klizhin,Chaco-McElmo Black-on-white (carbon paint),2,1090,1175,85,1,1,1
3155,Kin Klizhin,"Chuska Corrugated Gray Ware, Undifferentiated",62,890,1300,410,0,0,0
3155,Kin Klizhin,Chuska Indented Corrugated Gray,10,1040,1300,260,0,0,0
3155,Kin Klizhin,Chuska Narrow Neckbanded,2,825,950,125,0,1,0
3155,Kin Klizhin,"Chuska PII/PIII Gray, Type Undifferentiated",2,1040,1300,260,0,0,0
3155,Kin Klizhin,"Chuska PIII Gray, Type Undifferentiated",1,1100,1300,200,0,1,0
3155,Kin Klizhin,"Chuska Plain Gray Ware, Type Undifferentiated",3,700,925,225,0,0,0
3155,Kin Klizhin,"Chuska White Ware type, Undifferentiated",2,800,1300,500,0,1,1
3155,Kin Klizhin,"Cibola Black-on-white, Undifferentiated",20,550,1325,775,0,1,1
3155,Kin Klizhin,"Cibola Corrugated Gray Ware, Undifferentiated",157,900,1400,500,0,0,0
3155,Kin Klizhin,Cibola Indented Corrugated Gray,45,1040,1400,360,0,0,0
3155,Kin Klizhin,Cibola Narrow Neckbanded,3,900,1025,125,0,1,0
3155,Kin Klizhin,Cibola Neck Indented Corrugated,4,950,1025,75,0,1,0
3155,Kin Klizhin,"Cibola PII/PIII Gray Ware, Type Undifferentiated",7,950,1300,350,0,0,0
3155,Kin Klizhin,"Cibola PIII Gray Ware, Type Undifferentiated",2,1100,1300,200,0,1,0
3155,Kin Klizhin,Cibola Plain Gray,55,550,1040,490,0,0,0
3155,Kin Klizhin,"Cibola White Ware, Undifferentiated",55,550,1325,775,0,1,1
3155,Kin Klizhin,Cortez-Mancos Black-on-white,3,880,1180,300,1,1,1
3155,Kin Klizhin,Escavada Black-on-white,38,1000,1100,100,1,1,1
3155,Kin Klizhin,Escavada-Puerco Black-on-white,11,1000,1100,100,1,1,1
3155,Kin Klizhin,Gallup Black-on-white,42,1040,1150,110,1,1,1
3155,Kin Klizhin,McElmo Black-on-white,10,1060,1260,200,1,1,1
3155,Kin Klizhin,"PII/PIII White Ware, Type Undifferentiated",26,900,1300,400,0,1,1
3155,Kin Klizhin,Puerco Black-on-red,4,1000,1175,175,1,1,1
3155,Kin Klizhin,Puerco Black-on-white,1,1030,1200,170,1,1,1
3155,Kin Klizhin,Red Mesa Black-on-white,8,880,1040,160,1,1,1
3155,Kin Klizhin,Toadlena Black-on-white,1,975,1125,150,1,1,1
3155,Kin Klizhin,Tularosa Black-on-white,1,1180,1300,120,1,1,1
3155,Kin Klizhin,"White Mountain type, Type Undifferentiated; Early",8,1000,1300,300,0,0,1
3155,Kin Klizhin,Wingate Black-on-red,2,1050,1225,175,1,1,1
3156,Kin Nahasbas,Black Mesa/Sosi Black-on-white,4,1000,1180,180,1,1,1
3156,Kin Nahasbas,Bluff Black-on-red,2,800,925,125,1,1,1
3156,Kin Nahasbas,Chaco Black-on-white,18,1075,1150,75,1,1,1
3156,Kin Nahasbas,Chaco-McElmo Black-on-white (carbon paint),50,1090,1175,85,1,1,1
3156,Kin Nahasbas,Chuska Black-on-white,12,1040,1125,85,1,1,1
3156,Kin Nahasbas,"Chuska Carbon Painted White Ware, Undifferentiated",22,800,1300,500,0,1,1
3156,Kin Nahasbas,"Chuska Gray Ware, Type Undifferentiated",5,700,1300,600,0,0,0
3156,Kin Nahasbas,Chuska Indented Corrugated Gray,46,1040,1300,260,0,0,0
3156,Kin Nahasbas,"Chuska Mineral Painted White Ware, Undifferentiated",4,800,1300,500,0,1,1
3156,Kin Nahasbas,Chuska Neckbanded,1,800,950,150,0,1,0
3156,Kin Nahasbas,"Chuska Plain Gray Ware, Type Undifferentiated",22,700,925,225,0,0,0
3156,Kin Nahasbas,"Chuska White Ware type, Undifferentiated",26,800,1300,500,0,1,1
3156,Kin Nahasbas,"Cibola Corrugated Gray Ware, Undifferentiated",102,900,1400,500,0,0,0
3156,Kin Nahasbas,Cibola Indented Corrugated Gray,3,1040,1400,360,0,0,0
3156,Kin Nahasbas,Cibola Narrow Neckbanded Gray,10,900,1025,125,0,1,0
3156,Kin Nahasbas,Cibola Neck Indented Corrugated,2,950,1025,75,0,1,0
3156,Kin Nahasbas,Cibola Neckbanded Gray,77,850,1025,175,0,1,0
3156,Kin Nahasbas,"Cibola PII Gray Ware, Type Undifferentiated",6,950,1100,150,0,1,0
3156,Kin Nahasbas,"Cibola PII/PIII Gray Ware, Type Undifferentiated",4,950,1300,350,0,0,0
3156,Kin Nahasbas,"Cibola White Ware, Undifferentiated",1064,550,1325,775,0,1,1
3156,Kin Nahasbas,"Corrugated Gray Ware, Undifferentiated",883,800,1400,600,0,0,0
3156,Kin Nahasbas,Cortez Black-on-white,2,880,1060,180,1,1,1
3156,Kin Nahasbas,Deadmans (La Plata) Black-on-red,6,880,1050,170,1,1,1
3156,Kin Nahasbas,Escavada Black-on-white,17,1000,1100,100,1,1,1
3156,Kin Nahasbas,Gallup Black-on-white,301,1040,1150,110,1,1,1
3156,Kin Nahasbas,Gray Hills Banded,15,850,950,100,0,1,0
3156,Kin Nahasbas,"Gray Ware, Undifferentiated",45,400,1400,1000,0,0,0
3156,Kin Nahasbas,Holbrook Black-on-white,1,1050,1150,100,1,1,1
3156,Kin Nahasbas,Kana-a Black-on-white,5,825,1000,175,1,1,1
3156,Kin Nahasbas,Kiatuthlanna-Red Mesa Black-on-white,9,850,1040,190,1,1,1
3156,Kin Nahasbas,La Plata Black-on-white,8,550,750,200,1,1,1
3156,Kin Nahasbas,Lino Gray (Cibola),5,550,950,400,1,0,0
3156,Kin Nahasbas,Mancos Black-on-white,16,980,1180,200,1,1,1
3156,Kin Nahasbas,McElmo Black-on-white,5,1060,1260,200,1,1,1
3156,Kin Nahasbas,Medicine/Tusayan Black-on-red,1,1040,1240,200,1,1,1
3156,Kin Nahasbas,Mesa Verde Neckbanded Gray,1,800,1060,260,0,0,0
3156,Kin Nahasbas,"Mesa Verde White Ware, Undifferentiated",3,575,1280,705,0,1,1
3156,Kin Nahasbas,"Narrow Neckbanded Gray Ware, Type Undifferentiated",243,900,1025,125,0,1,0
3156,Kin Nahasbas,"Neck Indented Corrugated Gray Ware, Type Undifferentiated",8,950,1025,75,0,1,0
3156,Kin Nahasbas,Newcomb or Burnham Black-on-white,19,860,1000,140,1,1,1
3156,Kin Nahasbas,"PII Gray Rim, Type Undifferentiated",39,900,1100,200,0,1,0
3156,Kin Nahasbas,"PII/PIII Gray Rim, Type Undifferentiated",22,900,1300,400,0,0,0
3156,Kin Nahasbas,"PII/PIII White Ware, Type Undifferentiated",763,900,1300,400,0,1,1
3156,Kin Nahasbas,"PIII Gray Rim, Type Undifferentiated",1,1100,1300,200,0,1,0
3156,Kin Nahasbas,"Plain Gray Ware, Undifferentiated",909,500,1300,800,0,0,0
3156,Kin Nahasbas,Puerco Black-on-red,4,1000,1175,175,1,1,1
3156,Kin Nahasbas,Puerco Black-on-white,85,1030,1200,170,1,1,1
3156,Kin Nahasbas,Red Mesa Black-on-white,589,880,1040,160,1,1,1
3156,Kin Nahasbas,"San Juan Red ware, Undifferentiated",16,700,1050,350,0,0,1
3156,Kin Nahasbas,Sanostee Black-on-red,6,825,875,50,1,1,1
3156,Kin Nahasbas,Socorro Black-on-white,4,1050,1300,250,1,1,1
3156,Kin Nahasbas,Toadlena Black-on-white,13,975,1125,150,1,1,1
3156,Kin Nahasbas,"Tsegi Orange Ware, Undifferentiated",4,1000,1300,300,1,0,1
3156,Kin Nahasbas,Tunicha Black-on-white,14,850,900,50,1,1,1
3156,Kin Nahasbas,"Tusayan White Ware, Undifferentiated",8,825,1300,475,0,1,1
3156,Kin Nahasbas,White Mound Black-on-white,1,700,850,150,1,1,1
3156,Kin Nahasbas,"White Mountain type, Type Undifferentiated; Early",20,1000,1300,300,0,0,1
3156,Kin Nahasbas,"White ware, Undifferentiated",155,550,1900,1350,0,0,1
3156,Kin Nahasbas,"Wide Neckbanded Gray Ware, Type Undifferentiated",79,850,925,75,0,1,0
3156,Kin Nahasbas,Wingate Black-on-red,2,1050,1225,175,1,1,1
3156,Kin Nahasbas,Woodruff Smudged,16,500,1100,600,0,0,0
3157,Kin Sani,Chaco Black-on-white,3,1075,1150,75,1,1,1
3157,Kin Sani,Cibola Clapboard Corrugated Gray,2,900,1100,200,0,1,0
3157,Kin Sani,Cibola Indented Corrugated Gray,14,1040,1400,360,0,0,0
3157,Kin Sani,Cibola Narrow Neckbanded,6,900,1025,125,0,1,0
3157,Kin Sani,"Cibola PII Gray Ware, Type Undifferentiated",1,950,1100,150,0,1,0
3157,Kin Sani,"Cibola PII/PIII Gray Ware, Type Undifferentiated",3,950,1300,350,0,0,0
3157,Kin Sani,"Cibola PII/PIII White Ware, Type Undifferentiated",168,1000,1300,300,1,1,1
3157,Kin Sani,"Cibola White Ware, Undifferentiated",13,550,1325,775,0,1,1
3157,Kin Sani,Escavada Black-on-white,36,1000,1100,100,1,1,1
3157,Kin Sani,Gallup Black-on-white,95,1040,1150,110,1,1,1
3157,Kin Sani,Kiatuthlanna Black-on-white,7,850,925,75,1,1,1
3157,Kin Sani,"Mesa Verde White Ware, Undifferentiated",1,575,1280,705,0,1,1
3157,Kin Sani,Puerco Black-on-red,2,1000,1175,175,1,1,1
3157,Kin Sani,Puerco Black-on-white,2,1030,1200,170,1,1,1
3157,Kin Sani,Red Mesa Black-on-white,32,880,1040,160,1,1,1
3157,Kin Sani,Reserve Black-on-white,2,1050,1200,150,1,1,1
3157,Kin Sani,"San Juan Red ware, Undifferentiated",1,700,1050,350,0,0,1
3157,Kin Sani,White Mound Black-on-white,2,700,850,150,1,1,1
3157,Kin Sani,"White Mountain type, Type Undifferentiated; Early",1,1000,1300,300,0,0,1
3158,Kin Tliish,Chaco Black-on-white,11,1075,1150,75,1,1,1
3158,Kin Tliish,Chaco Corrugated,63,1050,1100,50,0,1,0
3158,Kin Tliish,Chaco-McElmo Black-on-white (carbon paint),7,1090,1175,85,1,1,1
3158,Kin Tliish,Chuska Black-on-white,1,1040,1125,85,1,1,1
3158,Kin Tliish,Cibola Clapboard Corrugated Gray,107,900,1100,200,0,1,0
3158,Kin Tliish,"Cibola PII Gray Ware, Type Undifferentiated",27,950,1100,150,0,1,0
3158,Kin Tliish,"Cibola PIII Gray Ware, Type Undifferentiated",5,1100,1300,200,0,1,0
3158,Kin Tliish,Cibola Plain Gray,357,550,1040,490,0,0,0
3158,Kin Tliish,Coolidge Corrugated,249,1050,1100,50,0,1,0
3158,Kin Tliish,"Corrugated Gray Ware, Undifferentiated",92,800,1400,600,0,0,0
3158,Kin Tliish,Cortez Black-on-white,1,880,1060,180,1,1,1
3158,Kin Tliish,Deadmans (La Plata) Black-on-red,1,880,1050,170,1,1,1
3158,Kin Tliish,Dogoszhi Black-on-white,1,1040,1210,170,1,1,1
3158,Kin Tliish,Escavada Black-on-white,35,1000,1100,100,1,1,1
3158,Kin Tliish,Gallup Black-on-white,46,1040,1150,110,1,1,1
3158,Kin Tliish,Kana'a Neckbanded,8,865,1060,195,0,1,0
3158,Kin Tliish,Kiatuthlanna Black-on-white,7,850,925,75,1,1,1
3158,Kin Tliish,La Plata Black-on-white,1,550,750,200,1,1,1
3158,Kin Tliish,Mancos Black-on-white,10,980,1180,200,1,1,1
3158,Kin Tliish,McElmo Black-on-white,2,1060,1260,200,1,1,1
3158,Kin Tliish,"Narrow Neckbanded Gray Ware, Type Undifferentiated",23,900,1025,125,0,1,0
3158,Kin Tliish,Puerco Black-on-red,22,1000,1175,175,1,1,1
3158,Kin Tliish,Puerco Black-on-white,20,1030,1200,170,1,1,1
3158,Kin Tliish,Red Mesa Black-on-white,15,880,1040,160,1,1,1
3158,Kin Tliish,"Red Ware type, Undifferentiated",61,700,1700,1000,0,0,0
3158,Kin Tliish,Reserve Black-on-white,20,1050,1200,150,1,1,1
3158,Kin Tliish,Taylor Black-on-white,2,1000,1100,100,1,1,1
3158,Kin Tliish,Tularosa Black-on-white,7,1180,1300,120,1,1,1
3158,Kin Tliish,White Mound Black-on-white,1,700,850,150,1,1,1
3158,Kin Tliish,"White ware, Undifferentiated",150,550,1900,1350,0,0,1
3158,Kin Tliish,Wingate Black-on-red,14,1050,1225,175,1,1,1
3160,Kin Ya'a,Chaco Black-on-white,3,1075,1150,75,1,1,1
3160,Kin Ya'a,Chaco-McElmo Black-on-white (carbon paint),1,1090,1175,85,1,1,1
3160,Kin Ya'a,"Cibola Black-on-white, Undifferentiated",105,550,1325,775,0,1,1
3160,Kin Ya'a,"Cibola Corrugated Gray Ware, Undifferentiated",157,900,1400,500,0,0,0
3160,Kin Ya'a,Cibola Indented Corrugated Gray,427,1040,1400,360,0,0,0
3160,Kin Ya'a,Cibola Narrow Neckbanded,108,900,1025,125,0,1,0
3160,Kin Ya'a,Cibola Neck Indented Corrugated,9,950,1025,75,0,1,0
3160,Kin Ya'a,"Cibola PII Gray Ware, Type Undifferentiated",15,950,1100,150,0,1,0
3160,Kin Ya'a,"Cibola PII/PIII Gray Ware, Type Undifferentiated",4,950,1300,350,0,0,0
3160,Kin Ya'a,"Cibola PIII Gray Ware, Type Undifferentiated",2,1100,1300,200,0,1,0
3160,Kin Ya'a,Cibola Plain Gray,297,550,1040,490,0,0,0
3160,Kin Ya'a,"Cibola White Ware, Undifferentiated",106,550,1325,775,0,1,1
3160,Kin Ya'a,Cibola Wide Neckbanded,32,850,925,75,0,1,0
3160,Kin Ya'a,Escavada Black-on-white,4,1000,1100,100,1,1,1
3160,Kin Ya'a,Gallup Black-on-white,84,1040,1150,110,1,1,1
3160,Kin Ya'a,Kana-a Black-on-white,1,825,1000,175,1,1,1
3160,Kin Ya'a,McElmo Black-on-white,3,1060,1260,200,1,1,1
3160,Kin Ya'a,Mesa Verde Black-on-white,1,1180,1280,100,1,1,1
3160,Kin Ya'a,"PII/PIII White Ware, Type Undifferentiated",26,900,1300,400,0,1,1
3160,Kin Ya'a,Puerco Black-on-white,25,1030,1200,170,1,1,1
3160,Kin Ya'a,Red Mesa Black-on-white,62,880,1040,160,1,1,1
3160,Kin Ya'a,"White Mountain type, Type Undifferentiated; Early",3,1000,1300,300,0,0,1
3160,Kin Ya'a,"White ware, Undifferentiated",262,550,1900,1350,0,0,1
3160,Kin Ya'a,Woodruff Smudged,4,500,1100,600,0,0,0
3164,LA 100280,Brimhall Black-on-white,1,1040,1150,110,1,1,1
3164,LA 100280,Chaco-McElmo Black-on-white (carbon paint),1,1090,1175,85,1,1,1
3164,LA 100280,"Chuska Gray Ware, Type Undifferentiated",1,700,1300,600,0,0,0
3164,LA 100280,"Cibola Gray Ware, Undifferentiated",177,550,1400,850,0,0,0
3164,LA 100280,Cibola Wide Neckbanded,20,850,925,75,0,1,0
3164,LA 100280,Drolet Black-on-white,1,900,1000,100,1,1,1
3164,LA 100280,Gallup Black-on-white,7,1040,1150,110,1,1,1
3164,LA 100280,Kiatuthlanna Black-on-white,2,850,925,75,1,1,1
3164,LA 100280,Red Mesa Black-on-white,2,880,1040,160,1,1,1
3164,LA 100280,Reserve Black-on-white,4,1050,1200,150,1,1,1
3164,LA 100280,White Mound Black-on-white,7,700,850,150,1,1,1
3164,LA 100280,Wingate Black-on-red,9,1050,1225,175,1,1,1
3165,LA 115436,"Cibola Black-on-white, Undifferentiated",108,550,1325,775,0,1,1
3165,LA 115436,Cibola Clapboard Corrugated Gray,8,900,1100,200,0,1,0
3165,LA 115436,Cibola Indented Corrugated Gray,161,1040,1400,360,0,0,0
3165,LA 115436,"Cibola PII Gray Ware, Type Undifferentiated",10,950,1100,150,0,1,0
3165,LA 115436,"Cibola PII White Ware, Type Undifferentiated",2,880,1100,220,1,1,1
3165,LA 115436,"Cibola PII/PIII Gray Ware, Type Undifferentiated",4,950,1300,350,0,0,0
3165,LA 115436,Gallup Black-on-white,2,1040,1150,110,1,1,1
3165,LA 115436,"Mogollon Corrugated Brown Ware, Undifferentiated",1,800,1400,600,0,0,0
3165,LA 115436,Mogollon Plain Brown Ware,1,300,1400,1100,0,0,0
3165,LA 115436,"Mogollon Plain Brown Ware, Smudged",1,300,1400,1100,0,0,0
3165,LA 115436,"PII White Ware, Type Undifferentiated",106,900,1100,200,1,1,1
3165,LA 115436,Puerco Black-on-red,10,1000,1175,175,1,1,1
3165,LA 115436,Puerco Black-on-white,8,1030,1200,170,1,1,1
3165,LA 115436,Reserve Black-on-white,9,1050,1200,150,1,1,1
3165,LA 115436,Showlow Red,3,1000,1100,100,0,1,0
3165,LA 115436,St. Johns Black-on-red,1,1200,1300,100,1,1,1
3165,LA 115436,St. Johns Black-on-red or Polychrome,1,1200,1300,100,1,1,1
3165,LA 115436,"White Mountain type, Type Undifferentiated; Early",80,1000,1300,300,0,0,1
3165,LA 115436,Wingate Black-on-red,6,1050,1225,175,1,1,1
3165,LA 115436,Wingate Black-on-red or Polychrome,6,1050,1225,175,1,1,1
3166,LA 12573 A,Chaco Black-on-white,1,1075,1150,75,1,1,1
3166,LA 12573 A,Deadmans (La Plata) Black-on-red,1,880,1050,170,1,1,1
3166,LA 12573 A,Escavada Black-on-white,15,1000,1100,100,1,1,1
3166,LA 12573 A,Gallup Black-on-white,15,1040,1150,110,1,1,1
3166,LA 12573 A,Red Mesa Black-on-white,25,880,1040,160,1,1,1
3166,LA 12573 A,Wingate Black-on-red,1,1050,1225,175,1,1,1
3167,LA 126820,"BMIII/PI White Ware, Type Undifferentiated",13,550,900,350,0,1,1
3167,LA 126820,Chuska Narrow Neckbanded,1,825,950,125,0,1,0
3167,LA 126820,"Chuska Plain Gray Ware, Type Undifferentiated",8,700,925,225,0,0,0
3167,LA 126820,Cibola Narrow Neckbanded,10,900,1025,125,0,1,0
3167,LA 126820,Cibola Plain Gray,343,550,1040,490,0,0,0
3167,LA 126820,"Cibola White Ware, Undifferentiated",21,550,1325,775,0,1,1
3167,LA 126820,Cibola Wide Neckbanded,2,850,925,75,0,1,0
3167,LA 126820,Lino Gray Fugitive Red [Cibola Series],1,550,850,300,1,0,0
3167,LA 126820,Newcomb or Burnham Black-on-white,1,860,1000,140,1,1,1
3167,LA 126820,Red Mesa Black-on-white,52,880,1040,160,1,1,1
3167,LA 126820,"San Juan Red ware, Undifferentiated",6,700,1050,350,0,0,1
3167,LA 126820,Sanostee Red-on-Orange,2,825,875,50,1,1,1
3167,LA 126820,Sheep Springs Gray,2,800,850,50,0,1,0
3168,LA 126862,"Chuska Carbon Painted White Ware, Undifferentiated",3,800,1300,500,0,1,1
3168,LA 126862,Chuska Indented Corrugated Gray,3,1040,1300,260,0,0,0
3168,LA 126862,"Cibola Gray Ware, Undifferentiated",9,550,1400,850,0,0,0
3168,LA 126862,Cibola Indented Corrugated Gray,91,1040,1400,360,0,0,0
3168,LA 126862,Cibola Narrow Neckbanded,27,900,1025,125,0,1,0
3168,LA 126862,Cibola Neck Indented Corrugated,1,950,1025,75,0,1,0
3168,LA 126862,"Cibola PII Gray Ware, Type Undifferentiated",3,950,1100,150,0,1,0
3168,LA 126862,Cibola Plain Gray,47,550,1040,490,0,0,0
3168,LA 126862,Gallup Black-on-white,46,1040,1150,110,1,1,1
3168,LA 126862,Gray Hills Banded,1,850,950,100,0,1,0
3168,LA 126862,"PII/PIII White Ware, Type Undifferentiated",51,900,1300,400,0,1,1
3168,LA 126862,Puerco Black-on-white,7,1030,1200,170,1,1,1
3168,LA 126862,Red Mesa Black-on-white,33,880,1040,160,1,1,1
3168,LA 126862,Tsegi Orange,1,1250,1300,50,1,1,1
3168,LA 126862,"White ware, Undifferentiated",66,550,1900,1350,0,0,1
3169,LA 17226,Cibola Indented Corrugated Gray,25,1040,1400,360,0,0,0
3169,LA 17226,Cibola Plain Gray,2,550,1040,490,0,0,0
3169,LA 17226,Escavada-Puerco Black-on-white,4,1000,1100,100,1,1,1
3169,LA 17226,Gallup Black-on-white,9,1040,1150,110,1,1,1
3169,LA 17226,McElmo Black-on-white,1,1060,1260,200,1,1,1
3169,LA 17226,Red Mesa Black-on-white,4,880,1040,160,1,1,1
3171,LA 2520,"Corrugated Gray Ware, Undifferentiated",15,800,1400,600,0,0,0
3171,LA 2520,"Indented Corrugated Gray Ware, Undifferentiated",413,950,1400,450,0,0,0
3171,LA 2520,Mancos Black-on-white,32,980,1180,200,1,1,1
3171,LA 2520,Mesa Verde Black-on-white,941,1180,1280,100,1,1,1
3171,LA 2520,Puerco Black-on-red,4,1000,1175,175,1,1,1
3177,LA 40081,"Chuska Plain Gray Ware, Type Undifferentiated",2,700,925,225,0,0,0
3177,LA 40081,"Chuska White Ware type, Undifferentiated",1,800,1300,500,0,1,1
3177,LA 40081,"Cibola BMIII/PI White Ware, Type Undifferentiated",32,550,900,350,0,1,1
3177,LA 40081,"Cibola Gray Ware, Undifferentiated",2,550,1400,850,0,0,0
3177,LA 40081,Cibola Narrow Neckbanded,1,900,1025,125,0,1,0
3177,LA 40081,Cibola Plain Gray,1621,550,1040,490,0,0,0
3177,LA 40081,Cibola Wide Neckbanded,11,850,925,75,0,1,0
3177,LA 40081,Kiatuthlanna Black-on-white,3,850,925,75,1,1,1
3177,LA 40081,La Plata Black-on-white,5,550,750,200,1,1,1
3177,LA 40081,Lino Gray (Cibola),63,550,950,400,1,0,0
3177,LA 40081,Lino Gray (trachyte),1,550,950,400,0,0,0
3177,LA 40081,"PII/PIII White Ware, Type Undifferentiated",2,900,1300,400,0,1,1
3177,LA 40081,"Plain Brown Smudged, Undifferentiated",1,400,1450,1050,0,0,0
3177,LA 40081,"Plain Gray Ware, Undifferentiated",151,500,1300,800,0,0,0
3177,LA 40081,Sanostee Black-on-red,3,825,875,50,1,1,1
3177,LA 40081,Sheep Springs Gray,1,800,850,50,0,1,0
3177,LA 40081,White Mound Black-on-white,28,700,850,150,1,1,1
3177,LA 40081,"White Mountain type, Type Undifferentiated; Early",1,1000,1300,300,0,0,1
3177,LA 40081,"White ware, Undifferentiated",22,550,1900,1350,0,0,1
3180,LA 40457,Black Mesa Black-on-white,1,1000,1100,100,1,1,1
3180,LA 40457,Chaco Black-on-white,1,1075,1150,75,1,1,1
3180,LA 40457,Chaco-McElmo Black-on-white (carbon paint),1,1090,1175,85,1,1,1
3180,LA 40457,"Chuska Carbon Painted White Ware, Undifferentiated",1,800,1300,500,0,1,1
3180,LA 40457,Chuska Indented Corrugated Gray,4,1040,1300,260,0,0,0
3180,LA 40457,"Chuska PII Gray, Type Undifferentiated",1,1040,1100,60,0,1,0
3180,LA 40457,"Chuska Plain Gray Ware, Type Undifferentiated",5,700,925,225,0,0,0
3180,LA 40457,"Chuska White Ware type, Undifferentiated",6,800,1300,500,0,1,1
3180,LA 40457,"Cibola BMIII/PI White Ware, Type Undifferentiated",10,550,900,350,0,1,1
3180,LA 40457,"Cibola Gray Ware, Undifferentiated",1,550,1400,850,0,0,0
3180,LA 40457,Cibola Indented Corrugated Gray,22,1040,1400,360,0,0,0
3180,LA 40457,Cibola Narrow Neckbanded,3,900,1025,125,0,1,0
3180,LA 40457,"Cibola PII Gray Ware, Type Undifferentiated",1,950,1100,150,0,1,0
3180,LA 40457,"Cibola PII/PIII Gray Ware, Type Undifferentiated",2,950,1300,350,0,0,0
3180,LA 40457,Cibola Plain Gray,264,550,1040,490,0,0,0
3180,LA 40457,Cibola Wide Neckbanded,4,850,925,75,0,1,0
3180,LA 40457,Gallup Black-on-white,4,1040,1150,110,1,1,1
3180,LA 40457,Kiatuthlanna Black-on-white,1,850,925,75,1,1,1
3180,LA 40457,La Plata Black-on-white,1,550,750,200,1,1,1
3180,LA 40457,Lino Gray (Cibola),11,550,950,400,1,0,0
3180,LA 40457,Lino Gray Fugitive Red [Cibola Series],1,550,850,300,1,0,0
3180,LA 40457,"PII/PIII White Ware, Type Undifferentiated",14,900,1300,400,0,1,1
3180,LA 40457,Red Mesa Black-on-white,13,880,1040,160,1,1,1
3180,LA 40457,"San Juan Red ware, Undifferentiated",1,700,1050,350,0,0,1
3180,LA 40457,White Mound Black-on-white,10,700,850,150,1,1,1
3180,LA 40457,"White ware, Undifferentiated",62,550,1900,1350,0,0,1
3180,LA 40457,Woodruff Smudged,2,500,1100,600,0,0,0
3181,LA 40631,Chaco Black-on-white,5,1075,1150,75,1,1,1
3181,LA 40631,Chaco-McElmo Black-on-white (carbon paint),1,1090,1175,85,1,1,1
3181,LA 40631,Chuska Black-on-white,2,1040,1125,85,1,1,1
3181,LA 40631,"Chuska Corrugated Gray Ware, Undifferentiated",4,890,1300,410,0,0,0
3181,LA 40631,"Chuska Gray Ware, Type Undifferentiated",2,700,1300,600,0,0,0
3181,LA 40631,"Chuska Plain Gray Ware, Type Undifferentiated",5,700,925,225,0,0,0
3181,LA 40631,"Cibola Corrugated Gray Ware, Undifferentiated",11,900,1400,500,0,0,0
3181,LA 40631,"Cibola Gray Ware, Undifferentiated",4,550,1400,850,0,0,0
3181,LA 40631,Cibola Narrow Neckbanded,11,900,1025,125,0,1,0
3181,LA 40631,"Cibola PIII Gray Ware, Type Undifferentiated",1,1100,1300,200,0,1,0
3181,LA 40631,Cibola Plain Gray,96,550,1040,490,0,0,0
3181,LA 40631,Cibola Wide Neckbanded,5,850,925,75,0,1,0
3181,LA 40631,"Corrugated Gray Ware, Undifferentiated",17,800,1400,600,0,0,0
3181,LA 40631,Escavada Black-on-white,1,1000,1100,100,1,1,1
3181,LA 40631,Gallup Black-on-white,12,1040,1150,110,1,1,1
3181,LA 40631,Gray Hills Banded,2,850,950,100,0,1,0
3181,LA 40631,Kana-a Black-on-white,1,825,1000,175,1,1,1
3181,LA 40631,Kiatuthlanna Black-on-white,1,850,925,75,1,1,1
3181,LA 40631,Lino Gray (Cibola),1,550,950,400,1,0,0
3181,LA 40631,McElmo Black-on-white,1,1060,1260,200,1,1,1
3181,LA 40631,"Mesa Verde Corrugated Gray Ware, Undifferentiated",1,920,1280,360,0,0,0
3181,LA 40631,"Narrow Neckbanded Gray Ware, Type Undifferentiated",19,900,1025,125,0,1,0
3181,LA 40631,"PII Gray Rim, Type Undifferentiated",3,900,1100,200,0,1,0
3181,LA 40631,"PII/PIII White Ware, Type Undifferentiated",12,900,1300,400,0,1,1
3181,LA 40631,"Plain Gray Ware, Undifferentiated",40,500,1300,800,0,0,0
3181,LA 40631,Puerco Black-on-red,1,1000,1175,175,1,1,1
3181,LA 40631,Puerco Black-on-white,1,1030,1200,170,1,1,1
3181,LA 40631,Red Mesa Black-on-white,78,880,1040,160,1,1,1
3181,LA 40631,Sheep Springs Gray,1,800,850,50,0,1,0
3181,LA 40631,White Mound Black-on-white,3,700,850,150,1,1,1
3181,LA 40631,"White Mountain type, Type Undifferentiated; Early",1,1000,1300,300,0,0,1
3181,LA 40631,"White ware, Undifferentiated",39,550,1900,1350,0,0,1
3181,LA 40631,"Wide Neckbanded Gray Ware, Type Undifferentiated",7,850,925,75,0,1,0
3183,LA 47526,Cebolleta Black-on-white,1,1000,1200,200,1,1,1
3183,LA 47526,Holbrook Black-on-white,1,1050,1150,100,1,1,1
3183,LA 47526,Kiatuthlanna Black-on-white,2,850,925,75,1,1,1
3183,LA 47526,Lino Gray (Cibola),1,550,950,400,1,0,0
3183,LA 47526,"Little Colorado Corrugated Gray Ware, Undifferentiated",11,1050,1250,200,0,1,0
3183,LA 47526,Puerco Black-on-red,6,1000,1175,175,1,1,1
3183,LA 47526,Puerco Black-on-white,49,1030,1200,170,1,1,1
3183,LA 47526,Red Mesa Black-on-white,2,880,1040,160,1,1,1
3183,LA 47526,Tusayan Corrugated,17,1020,1275,255,0,0,0
3183,LA 47526,"Type, Undifferentiated",14,200,1900,1700,0,0,0
3183,LA 47526,White Mound Black-on-white,3,700,850,150,1,1,1
3183,LA 47526,Wingate Black-on-red,3,1050,1225,175,1,1,1
3188,LA 60002,Chaco-McElmo Black-on-white (carbon paint),2,1090,1175,85,1,1,1
3188,LA 60002,"Corrugated Gray Ware, Undifferentiated",33,800,1400,600,0,0,0
3188,LA 60002,Escavada-Puerco Black-on-white,1,1000,1100,100,1,1,1
3188,LA 60002,Gallup Black-on-white,1,1040,1150,110,1,1,1
3188,LA 60002,"Indented Corrugated Gray Ware, Undifferentiated",14,950,1400,450,0,0,0
3188,LA 60002,Mancos Black-on-white,2,980,1180,200,1,1,1
3188,LA 60002,McElmo Black-on-white,6,1060,1260,200,1,1,1
3188,LA 60002,"Mesa Verde PII/PIII White Ware, Type Undifferentiated",2,920,1280,360,0,1,1
3188,LA 60002,"Mesa Verde White Ware, Undifferentiated",1,575,1280,705,0,1,1
3188,LA 60002,"PII/PIII White Ware, Type Undifferentiated",7,900,1300,400,0,1,1
3188,LA 60002,"Plain Gray Ware, Undifferentiated",2,500,1300,800,0,0,0
3188,LA 60002,Toadlena Black-on-white,2,975,1125,150,1,1,1
3188,LA 60002,"White ware, Undifferentiated",26,550,1900,1350,0,0,1
3189,LA 60006,Brimhall Black-on-white,1,1040,1150,110,1,1,1
3189,LA 60006,Chaco Black-on-white,1,1075,1150,75,1,1,1
3189,LA 60006,"Corrugated Gray Ware, Undifferentiated",38,800,1400,600,0,0,0
3189,LA 60006,Gallup Black-on-white,3,1040,1150,110,1,1,1
3189,LA 60006,"Indented Corrugated Gray Ware, Undifferentiated",24,950,1400,450,0,0,0
3189,LA 60006,Mancos Black-on-white,2,980,1180,200,1,1,1
3189,LA 60006,"Mesa Verde PII/PIII White Ware, Type Undifferentiated",2,920,1280,360,0,1,1
3189,LA 60006,"Mesa Verde White Ware, Undifferentiated",2,575,1280,705,0,1,1
3189,LA 60006,Nava Black-on-white,4,1100,1275,175,1,1,1
3189,LA 60006,"PII/PIII Gray Rim, Type Undifferentiated",4,900,1300,400,0,0,0
3189,LA 60006,"Plain Gray Ware, Undifferentiated",14,500,1300,800,0,0,0
3189,LA 60006,Sosi Black-on-white,1,1070,1180,110,1,1,1
3189,LA 60006,Wetherill Black-on-white,3,1060,1180,120,1,1,1
3189,LA 60006,"White Mountain type, Type Undifferentiated; Early",4,1000,1300,300,0,0,1
3189,LA 60006,"White ware, Undifferentiated",8,550,1900,1350,0,0,1
3191,LA 60022,Chaco-McElmo Black-on-white (carbon paint),4,1090,1175,85,1,1,1
3191,LA 60022,"Chuska Carbon Painted White Ware, Undifferentiated",1,800,1300,500,0,1,1
3191,LA 60022,"Chuska PII/PIII Black-on-white, Type Undifferentiated",1,900,1300,400,0,1,1
3191,LA 60022,"Corrugated Gray Ware, Undifferentiated",224,800,1400,600,0,0,0
3191,LA 60022,Escavada-Puerco Black-on-white,1,1000,1100,100,1,1,1
3191,LA 60022,Gallup Black-on-white,2,1040,1150,110,1,1,1
3191,LA 60022,"Indented Corrugated Gray Ware, Undifferentiated",153,950,1400,450,0,0,0
3191,LA 60022,Mancos Black-on-white,16,980,1180,200,1,1,1
3191,LA 60022,McElmo Black-on-white,26,1060,1260,200,1,1,1
3191,LA 60022,"Mesa Verde PII/PIII White Ware, Type Undifferentiated",12,920,1280,360,0,1,1
3191,LA 60022,"Neck Indented Corrugated Gray Ware, Type Undifferentiated",7,950,1025,75,0,1,0
3191,LA 60022,"PII White Ware, Type Undifferentiated",1,900,1100,200,1,1,1
3191,LA 60022,"PII/PIII Gray Rim, Type Undifferentiated",7,900,1300,400,0,0,0
3191,LA 60022,"PII/PIII White Ware, Type Undifferentiated",11,900,1300,400,0,1,1
3191,LA 60022,"Plain Gray Ware, Undifferentiated",58,500,1300,800,0,0,0
3191,LA 60022,"Red Ware type, Undifferentiated",6,700,1700,1000,0,0,0
3191,LA 60022,Sosi Black-on-white,2,1070,1180,110,1,1,1
3191,LA 60022,Tusayan Polychrome,2,1110,1320,210,1,1,1
3191,LA 60022,"White Mountain type, Type Undifferentiated; Early",3,1000,1300,300,0,0,1
3191,LA 60022,"White ware, Undifferentiated",114,550,1900,1350,0,0,1
3191,LA 60022,Woodruff Brown,2,500,1100,600,0,0,0
3191,LA 60022,Woodruff Red Smudged,2,400,1100,700,0,0,0
3194,LA 67158,Cibola Indented Corrugated Gray,45,1040,1400,360,0,0,0
3194,LA 67158,Cibola Narrow Neckbanded,1,900,1025,125,0,1,0
3194,LA 67158,Cibola Neck Indented Corrugated,1,950,1025,75,0,1,0
3194,LA 67158,"Cibola PII Gray Ware, Type Undifferentiated",2,950,1100,150,0,1,0
3194,LA 67158,"Cibola PII/PIII White Ware, Type Undifferentiated",10,1000,1300,300,1,1,1
3194,LA 67158,Cibola Plain Corrugated Gray,12,900,1100,200,0,1,0
3194,LA 67158,Cibola Plain Gray,29,550,1040,490,0,0,0
3194,LA 67158,"Cibola White Ware, Undifferentiated",11,550,1325,775,0,1,1
3194,LA 67158,Gallup Black-on-white,11,1040,1150,110,1,1,1
3194,LA 67158,Puerco Black-on-white,1,1030,1200,170,1,1,1
3194,LA 67158,Red Mesa Black-on-white,6,880,1040,160,1,1,1
3194,LA 67158,"Type, Undifferentiated",2,200,1900,1700,0,0,0
3199,LA 7603,Bennett Gray,1,700,850,150,0,1,0
3199,LA 7603,Blue Shale Corrugated,55,925,1150,225,0,0,0
3199,LA 7603,Brimhall Black-on-white,7,1040,1150,110,1,1,1
3199,LA 7603,Burnham Black-on-white,4,860,1000,140,1,1,1
3199,LA 7603,Chuska Black-on-white,13,1040,1125,85,1,1,1
3199,LA 7603,Hunter Corrugated,1,1100,1300,200,0,1,0
3199,LA 7603,Lino Gray (Cibola),2,550,950,400,1,0,0
3199,LA 7603,Mancos Corrugated,1,920,1180,260,0,0,0
3199,LA 7603,McElmo Black-on-white,1,1060,1260,200,1,1,1
3199,LA 7603,Naschitti Black-on-white,2,900,1000,100,1,1,1
3199,LA 7603,Newcomb Black-on-white,12,875,1000,125,1,1,1
3199,LA 7603,Red Mesa Black-on-white,7,880,1040,160,1,1,1
3199,LA 7603,"San Juan Red ware, Undifferentiated",2,700,1050,350,0,0,1
3199,LA 7603,Toadlena Black-on-white,10,975,1125,150,1,1,1
3199,LA 7603,Tusayan Polychrome,1,1110,1320,210,1,1,1
3200,LA 8244,Bennett Gray,7,700,850,150,0,1,0
3200,LA 8244,Blue Shale Corrugated,53,925,1150,225,0,0,0
3200,LA 8244,Brimhall Black-on-white,3,1040,1150,110,1,1,1
3200,LA 8244,Burnham Black-on-white,18,860,1000,140,1,1,1
3200,LA 8244,Captain Tom Corrugated,9,890,1000,110,0,1,0
3200,LA 8244,Chuska Black-on-white,42,1040,1125,85,1,1,1
3200,LA 8244,Cortez Black-on-white,1,880,1060,180,1,1,1
3200,LA 8244,Deadmans (La Plata) Black-on-red,9,880,1050,170,1,1,1
3200,LA 8244,Gallup Black-on-white,4,1040,1150,110,1,1,1
3200,LA 8244,Gray Hills Banded,13,850,950,100,0,1,0
3200,LA 8244,Hunter Corrugated,2,1100,1300,200,0,1,0
3200,LA 8244,Mancos Black-on-white,2,980,1180,200,1,1,1
3200,LA 8244,Naschitti Black-on-white,2,900,1000,100,1,1,1
3200,LA 8244,Newcomb Black-on-white,56,875,1000,125,1,1,1
3200,LA 8244,Newcomb Corrugated,6,875,950,75,0,1,0
3200,LA 8244,Pena Black-on-white,4,800,900,100,1,1,1
3200,LA 8244,Red Mesa Black-on-white,6,880,1040,160,1,1,1
3200,LA 8244,"San Juan Red ware, Undifferentiated",17,700,1050,350,0,0,1
3200,LA 8244,Taylor Black-on-white,2,1000,1100,100,1,1,1
3200,LA 8244,Toadlena Black-on-white,10,975,1125,150,1,1,1
3200,LA 8244,Tocito Gray,4,825,875,50,0,1,0
3200,LA 8244,Tunicha Black-on-white,3,850,900,50,1,1,1
3200,LA 8244,Tusayan Black-on-red,1,1045,1240,195,1,1,1
3200,LA 8244,Tusayan Corrugated,1,1020,1275,255,0,0,0
3200,LA 8244,"Type, Undifferentiated",1,200,1900,1700,0,0,0
3201,LA 82742,"Cibola Black-on-white, Undifferentiated",45,550,1325,775,0,1,1
3201,LA 82742,Cibola Indented Corrugated Gray,152,1040,1400,360,0,0,0
3201,LA 82742,Cibola Plain Corrugated Gray,5,900,1100,200,0,1,0
3201,LA 82742,Cibola Plain Gray,20,550,1040,490,0,0,0
3201,LA 82742,"Cibola White Ware, Undifferentiated",15,550,1325,775,0,1,1
3201,LA 82742,Puerco Black-on-red,3,1000,1175,175,1,1,1
3201,LA 82742,Puerco Black-on-white,3,1030,1200,170,1,1,1
3201,LA 82742,Red Mesa Black-on-white,1,880,1040,160,1,1,1
3201,LA 82742,St. Johns Black-on-red or Polychrome,20,1200,1300,100,1,1,1
3201,LA 82742,Tularosa Black-on-white,4,1180,1300,120,1,1,1
3201,LA 82742,"Type, Undifferentiated",26,200,1900,1700,0,0,0
3201,LA 82742,"White Mountain type, Type Undifferentiated; Early",86,1000,1300,300,0,0,1
3201,LA 82742,Wingate Black-on-red,6,1050,1225,175,1,1,1
3201,LA 82742,Wingate Polychrome,5,1100,1225,125,1,1,1
3202,LA 8620,Blue Shale Corrugated,9,925,1150,225,0,0,0
3202,LA 8620,Crumbled House Black-on-white,2,1150,1300,150,1,1,1
3202,LA 8620,Hunter Corrugated,4,1100,1300,200,0,1,0
3202,LA 8620,Mancos Corrugated,7,920,1180,260,0,0,0
3202,LA 8620,McElmo Black-on-white,15,1060,1260,200,1,1,1
3202,LA 8620,Mesa Verde Black-on-white,5,1180,1280,100,1,1,1
3202,LA 8620,Mesa Verde Corrugated,11,1100,1280,180,0,1,0
3202,LA 8620,Nava Black-on-white,1,1100,1275,175,1,1,1
3202,LA 8620,"White Mountain type, Type Undifferentiated; Early",1,1000,1300,300,0,0,1
3203,LA 98500,Arboles Black-on-white,2,950,1050,100,1,1,1
3203,LA 98500,Arboles Coiled or Corrugated,1,975,1050,75,0,1,0
3203,LA 98500,Arboles Gray,63,900,1050,150,0,1,0
3203,LA 98500,Arboles Neckbanded,10,900,1050,150,0,1,0
3203,LA 98500,Bancos Black-on-white,2,825,1000,175,1,1,1
3203,LA 98500,"Clapboard Corrugated Gray Ware, Undifferentiated",1,900,1100,200,0,1,0
3203,LA 98500,"Gray Ware, Undifferentiated",52,400,1400,1000,0,0,0
3203,LA 98500,"Neckbanded Gray Ware, Undifferentiated",35,850,1025,175,0,1,0
3203,LA 98500,Piedra Black-on-white,16,800,920,120,1,1,1
3203,LA 98500,"Plain Gray Ware, Undifferentiated",207,500,1300,800,0,0,0
3203,LA 98500,Rosa Gray,1,700,1000,300,0,0,0
3203,LA 98500,"White ware, Undifferentiated",6,550,1900,1350,0,0,1
3204,Lake Valley,Abajo Red-on-orange,1,760,880,120,1,1,1
3204,Lake Valley,Black Mesa/Sosi Black-on-white,1,1000,1180,180,1,1,1
3204,Lake Valley,Blue Shale Corrugated,10,925,1150,225,0,0,0
3204,Lake Valley,Bluff Black-on-red,3,800,925,125,1,1,1
3204,Lake Valley,Burnham Black-on-white,4,860,1000,140,1,1,1
3204,Lake Valley,Captain Tom Corrugated,1,890,1000,110,0,1,0
3204,Lake Valley,Chaco Black-on-white,1,1075,1150,75,1,1,1
3204,Lake Valley,Chaco-McElmo Black-on-white (carbon paint),38,1090,1175,85,1,1,1
3204,Lake Valley,Chuska Black-on-white,2,1040,1125,85,1,1,1
3204,Lake Valley,"Chuska Carbon Painted White Ware, Undifferentiated",7,800,1300,500,0,1,1
3204,Lake Valley,"Chuska Gray Ware, Type Undifferentiated",8,700,1300,600,0,0,0
3204,Lake Valley,Chuska Indented Corrugated Gray,35,1040,1300,260,0,0,0
3204,Lake Valley,Chuska Neck Indented Corrugated Gray,7,950,1025,75,0,1,0
3204,Lake Valley,Chuska Neckbanded,2,800,950,150,0,1,0
3204,Lake Valley,"Chuska Plain Gray Ware, Type Undifferentiated",103,700,925,225,0,0,0
3204,Lake Valley,"Chuska White Ware type, Undifferentiated",16,800,1300,500,0,1,1
3204,Lake Valley,"Cibola Black-on-white, Undifferentiated",3,550,1325,775,0,1,1
3204,Lake Valley,"Cibola Gray Ware, Undifferentiated",4,550,1400,850,0,0,0
3204,Lake Valley,Cibola Indented Corrugated Gray,27,1040,1400,360,0,0,0
3204,Lake Valley,Cibola Narrow Neckbanded,16,900,1025,125,0,1,0
3204,Lake Valley,Cibola Neck Indented Corrugated,8,950,1025,75,0,1,0
3204,Lake Valley,Cibola Neckbanded Gray,5,850,1025,175,0,1,0
3204,Lake Valley,Cibola Plain Gray,158,550,1040,490,0,0,0
3204,Lake Valley,Cibola Wide Neckbanded,6,850,925,75,0,1,0
3204,Lake Valley,Coolidge Corrugated,1,1050,1100,50,0,1,0
3204,Lake Valley,Deadmans (La Plata) Black-on-red,2,880,1050,170,1,1,1
3204,Lake Valley,Escavada Black-on-white,2,1000,1100,100,1,1,1
3204,Lake Valley,Gallup Black-on-white,15,1040,1150,110,1,1,1
3204,Lake Valley,Gray Hills Banded,26,850,950,100,0,1,0
3204,Lake Valley,Hunter Corrugated,2,1100,1300,200,0,1,0
3204,Lake Valley,Kana-a Black-on-white,1,825,1000,175,1,1,1
3204,Lake Valley,Kiatuthlanna Black-on-white,14,850,925,75,1,1,1
3204,Lake Valley,La Plata Black-on-white,1,550,750,200,1,1,1
3204,Lake Valley,Lino Gray (Cibola),5,550,950,400,1,0,0
3204,Lake Valley,Lino Gray (trachyte),1,550,950,400,0,0,0
3204,Lake Valley,McElmo/Mesa Verde Black-on-white,1,1060,1280,220,1,1,1
3204,Lake Valley,Mesa Verde Black-on-white,2,1180,1280,100,1,1,1
3204,Lake Valley,"PII/PIII White Ware, Type Undifferentiated",23,900,1300,400,0,1,1
3204,Lake Valley,Puerco Black-on-red,3,1000,1175,175,1,1,1
3204,Lake Valley,Red Mesa Black-on-white,33,880,1040,160,1,1,1
3204,Lake Valley,Reserve Black-on-white,2,1050,1200,150,1,1,1
3204,Lake Valley,"San Juan Red ware, Undifferentiated",2,700,1050,350,0,0,1
3204,Lake Valley,Sanostee Black-on-red,1,825,875,50,1,1,1
3204,Lake Valley,Sheep Springs Gray,13,800,850,50,0,1,0
3204,Lake Valley,St. Johns Polychrome,2,1200,1300,100,1,1,1
3204,Lake Valley,Taylor Black-on-white,3,1000,1100,100,1,1,1
3204,Lake Valley,Toadlena Black-on-white,8,975,1125,150,1,1,1
3204,Lake Valley,Tocito Gray,1,825,875,50,0,1,0
3204,Lake Valley,Tunicha Black-on-white,6,850,900,50,1,1,1
3204,Lake Valley,"White Mountain type, Type Undifferentiated; Early",2,1000,1300,300,0,0,1
3204,Lake Valley,"White ware, Undifferentiated",53,550,1900,1350,0,0,1
3204,Lake Valley,Wingate Black-on-red,2,1050,1225,175,1,1,1
3204,Lake Valley,Wingate Polychrome,5,1100,1225,125,1,1,1
3204,Lake Valley,Woodruff Smudged,1,500,1100,600,0,0,0
3207,Lancaster,Abajo Red-on-orange,2,760,880,120,1,1,1
3207,Lancaster,Chapin Black-on-white,2,575,880,305,0,1,1
3207,Lancaster,Chapin Gray,3,575,980,405,0,0,0
3207,Lancaster,Cortez Black-on-white,6,880,1060,180,1,1,1
3207,Lancaster,Deadmans (La Plata) Black-on-red,3,880,1050,170,1,1,1
3207,Lancaster,Dolores Corrugated,6,1100,1200,100,0,1,0
3207,Lancaster,Gallup Black-on-white,2,1040,1150,110,1,1,1
3207,Lancaster,Mancos Black-on-white,186,980,1180,200,1,1,1
3207,Lancaster,Mancos Corrugated,14,920,1180,260,0,0,0
3207,Lancaster,McElmo Black-on-white,179,1060,1260,200,1,1,1
3207,Lancaster,Mesa Verde Black-on-white,106,1180,1280,100,1,1,1
3207,Lancaster,"Mesa Verde BMIII/PI White Ware, Type Undifferentiated",26,575,920,345,0,1,1
3207,Lancaster,Mesa Verde Corrugated,29,1100,1280,180,0,1,0
3207,Lancaster,"Mesa Verde Corrugated Gray Ware, Undifferentiated",701,920,1280,360,0,0,0
3207,Lancaster,"Mesa Verde PII White Ware, Type Undifferentiated",43,920,1100,180,1,1,1
3207,Lancaster,"Mesa Verde PII/PIII White Ware, Type Undifferentiated",398,920,1280,360,0,1,1
3207,Lancaster,"Mesa Verde PIII White Ware, Type Undifferentiated",114,1100,1280,180,1,1,1
3207,Lancaster,Mesa Verde Plain Gray,171,575,1020,445,0,0,0
3207,Lancaster,Piedra Black-on-white,2,800,920,120,1,1,1
3207,Lancaster,Puerco Black-on-white,1,1030,1200,170,1,1,1
3207,Lancaster,"Red Ware type, Undifferentiated",1,700,1700,1000,0,0,0
3207,Lancaster,Tin Cup Polychrome,1,1000,1100,100,1,1,1
3207,Lancaster,Tusayan Polychrome,2,1110,1320,210,1,1,1
3208,Loma Enebro,Arboles Gray,91,900,1050,150,0,1,0
3208,Loma Enebro,Arboles Neckbanded,10,900,1050,150,0,1,0
3208,Loma Enebro,Piedra Black-on-white,1,800,920,120,1,1,1
3208,Loma Enebro,Piedra Gray,16,850,1050,200,0,1,0
3208,Loma Enebro,"Plain Gray Ware, Undifferentiated",5,500,1300,800,0,0,0
3208,Loma Enebro,"Red Ware type, Undifferentiated",3,700,1700,1000,0,0,0
3208,Loma Enebro,Rosa Black-on-white,1,700,875,175,1,1,1
3208,Loma Enebro,Rosa Gray,5,700,1000,300,0,0,0
3208,Loma Enebro,"White ware, Undifferentiated",11,550,1900,1350,0,0,1
3209,Longacre 15,"Indented Corrugated Gray Ware, Undifferentiated",9,950,1400,450,0,0,0
3209,Longacre 15,Mogollon Indented Corrugated Brown Ware,2,1000,1400,400,0,0,0
3209,Longacre 15,Red Mesa Black-on-white,2,880,1040,160,1,1,1
3209,Longacre 15,Reserve Black-on-white,7,1050,1200,150,1,1,1
3209,Longacre 15,Snowflake Black-on-white,3,1100,1275,175,1,1,1
3209,Longacre 15,Tularosa Black-on-white,8,1180,1300,120,1,1,1
3209,Longacre 15,"White ware, Undifferentiated",17,550,1900,1350,0,0,1
3209,Longacre 15,Wingate Black-on-red,4,1050,1225,175,1,1,1
3210,Los Veteados Great Kiva,Alma Plain,4,300,1000,700,0,0,0
3210,Los Veteados Great Kiva,Cebolleta Black-on-white,21,1000,1200,200,1,1,1
3210,Los Veteados Great Kiva,Cibola Clapboard Corrugated Gray,1,900,1100,200,0,1,0
3210,Los Veteados Great Kiva,Cibola Indented Corrugated Gray,4,1040,1400,360,0,0,0
3210,Los Veteados Great Kiva,Cibola Plain Gray,19,550,1040,490,0,0,0
3210,Los Veteados Great Kiva,"Cibola White Ware, Undifferentiated",10,550,1325,775,0,1,1
3210,Los Veteados Great Kiva,Escavada Black-on-white,2,1000,1100,100,1,1,1
3210,Los Veteados Great Kiva,"Mogollon Plain Brown Ware, Smudged",1,300,1400,1100,0,0,0
3210,Los Veteados Great Kiva,"Neckbanded Gray Ware, Undifferentiated",2,850,1025,175,0,1,0
3210,Los Veteados Great Kiva,Red Mesa Black-on-white,1,880,1040,160,1,1,1
3210,Los Veteados Great Kiva,Socorro Black-on-white,12,1050,1300,250,1,1,1
3210,Los Veteados Great Kiva,Three Circle Neck Corrugated,1,800,1000,200,0,1,0
3210,Los Veteados Great Kiva,Tularosa Black-on-white,1,1180,1300,120,1,1,1
3210,Los Veteados Great Kiva,"White Mountain type, Type Undifferentiated; Early",2,1000,1300,300,0,0,1
3210,Los Veteados Great Kiva,"White ware, Undifferentiated",14,550,1900,1350,0,0,1
3211,Lower Cow Canyon,McElmo Black-on-white,21,1060,1260,200,1,1,1
3211,Lower Cow Canyon,Mesa Verde Black-on-white,33,1180,1280,100,1,1,1
3211,Lower Cow Canyon,Mesa Verde Corrugated,6,1100,1280,180,0,1,0
3211,Lower Cow Canyon,"Mesa Verde Corrugated Gray Ware, Undifferentiated",362,920,1280,360,0,0,0
3211,Lower Cow Canyon,"Mesa Verde PII/PIII White Ware, Type Undifferentiated",172,920,1280,360,0,1,1
3211,Lower Cow Canyon,"Mesa Verde PIII White Ware, Type Undifferentiated",97,1100,1280,180,1,1,1
3211,Lower Cow Canyon,Mesa Verde Plain Gray,4,575,1020,445,0,0,0
3211,Lower Cow Canyon,Piedra Black-on-white,2,800,920,120,1,1,1
3212,Lower Greenlee,Chuska Indented Corrugated Gray,12,1040,1300,260,0,0,0
3212,Lower Greenlee,Cibola Clapboard Corrugated Gray,10,900,1100,200,0,1,0
3212,Lower Greenlee,Cibola Indented Corrugated Gray,68,1040,1400,360,0,0,0
3212,Lower Greenlee,Cibola Neckbanded Gray,18,850,1025,175,0,1,0
3212,Lower Greenlee,Cibola Plain Gray,102,550,1040,490,0,0,0
3212,Lower Greenlee,Escavada-Puerco Black-on-white,16,1000,1100,100,1,1,1
3212,Lower Greenlee,Gallup Black-on-white,22,1040,1150,110,1,1,1
3212,Lower Greenlee,Mancos Black-on-white,2,980,1180,200,1,1,1
3212,Lower Greenlee,McElmo Black-on-white,2,1060,1260,200,1,1,1
3212,Lower Greenlee,Red Mesa Black-on-white,64,880,1040,160,1,1,1
3212,Lower Greenlee,"Tsegi Orange Ware, Undifferentiated",2,1000,1300,300,1,0,1
3212,Lower Greenlee,"White Mountain type, Type Undifferentiated; Early",2,1000,1300,300,0,0,1
3212,Lower Greenlee,"White ware, Undifferentiated",40,550,1900,1350,0,0,1
3213,Lower Kin Nizhoni,Cibola Indented Corrugated Gray,52,1040,1400,360,0,0,0
3213,Lower Kin Nizhoni,Cibola Neckbanded Gray,3,850,1025,175,0,1,0
3213,Lower Kin Nizhoni,Cibola Plain Gray,7,550,1040,490,0,0,0
3213,Lower Kin Nizhoni,Escavada-Puerco Black-on-white,5,1000,1100,100,1,1,1
3213,Lower Kin Nizhoni,Gallup Black-on-white,10,1040,1150,110,1,1,1
3213,Lower Kin Nizhoni,Red Mesa Black-on-white,2,880,1040,160,1,1,1
3214,Lowry,Abajo Red-on-orange,22,760,880,120,1,1,1
3214,Lowry,Black Mesa Black-on-white,204,1000,1100,100,1,1,1
3214,Lowry,"Black-on-red, Undifferentiated",4,700,1700,1000,0,1,1
3214,Lowry,Chapin Black-on-white,1,575,880,305,0,1,1
3214,Lowry,Chapin Gray,14,575,980,405,0,0,0
3214,Lowry,Cortez Black-on-white,13,880,1060,180,1,1,1
3214,Lowry,Deadmans (La Plata) Black-on-red,93,880,1050,170,1,1,1
3214,Lowry,Lino Black-on-gray (Tusayan),19,600,850,250,1,1,1
3214,Lowry,Lino Gray (Cibola),42,550,950,400,1,0,0
3214,Lowry,Lino Gray (Tusayan),72,550,950,400,0,0,0
3214,Lowry,Mancos Black-on-white,1338,980,1180,200,1,1,1
3214,Lowry,Mancos Corrugated,202,920,1180,260,0,0,0
3214,Lowry,Mancos Gray,36,880,1060,180,0,1,0
3214,Lowry,McElmo Black-on-white,303,1060,1260,200,1,1,1
3214,Lowry,Mesa Verde Black-on-white,99,1180,1280,100,1,1,1
3214,Lowry,Mesa Verde Corrugated,1126,1100,1280,180,0,1,0
3214,Lowry,"Mesa Verde Corrugated Gray Ware, Undifferentiated",2228,920,1280,360,0,0,0
3214,Lowry,"Mesa Verde PII/PIII White Ware, Type Undifferentiated",4,920,1280,360,0,1,1
3214,Lowry,Mesa Verde Plain Gray,1309,575,1020,445,0,0,0
3214,Lowry,Moccasin Gray,5,800,980,180,0,1,0
3214,Lowry,Piedra Black-on-white,1,800,920,120,1,1,1
3214,Lowry,Red Mesa Black-on-white,35,880,1040,160,1,1,1
3214,Lowry,Rio Grande Neck Corrugtaed Gray,371,900,1000,100,0,1,0
3214,Lowry,"San Juan Red ware, Undifferentiated",4,700,1050,350,0,0,1
3214,Lowry,Sunset Red/Sunset Brown,7,1065,1200,135,0,1,0
3214,Lowry,Tusayan Black-on-red,26,1045,1240,195,1,1,1
3214,Lowry,Tusayan Black-on-white,10,1200,1300,100,1,1,1
3214,Lowry,Tusayan Polychrome,20,1110,1320,210,1,1,1
3214,Lowry,"Type, Undifferentiated",45,200,1900,1700,0,0,0
3214,Lowry,Wingate Black-on-red,55,1050,1225,175,1,1,1
3215,LZ 1090 Group,"Cibola Black-on-white, Undifferentiated",18,550,1325,775,0,1,1
3215,LZ 1090 Group,Cibola Indented Corrugated Gray,12,1040,1400,360,0,0,0
3215,LZ 1090 Group,Cibola Plain Corrugated Gray,2,900,1100,200,0,1,0
3215,LZ 1090 Group,Cibola Plain Gray,93,550,1040,490,0,0,0
3215,LZ 1090 Group,Escavada Black-on-white,2,1000,1100,100,1,1,1
3215,LZ 1090 Group,Kiatuthlanna Black-on-white,5,850,925,75,1,1,1
3215,LZ 1090 Group,Lino Gray (Cibola),88,550,950,400,1,0,0
3215,LZ 1090 Group,"Mogollon Brown ware, Undifferentiated",4,900,1400,500,0,0,0
3215,LZ 1090 Group,"Mogollon Plain Brown Ware, Smudged",5,300,1400,1100,0,0,0
3215,LZ 1090 Group,Puerco Black-on-white,1,1030,1200,170,1,1,1
3215,LZ 1090 Group,Red Mesa Black-on-white,5,880,1040,160,1,1,1
3215,LZ 1090 Group,Reserve Black-on-white,3,1050,1200,150,1,1,1
3217,Mancos Canyon,Abajo Red-on-orange,11,760,880,120,1,1,1
3217,Mancos Canyon,Bluff Black-on-red,2,800,925,125,1,1,1
3217,Mancos Canyon,Chapin Gray,13,575,980,405,0,0,0
3217,Mancos Canyon,Cortez Black-on-white,33,880,1060,180,1,1,1
3217,Mancos Canyon,Mancos Black-on-white,73,980,1180,200,1,1,1
3217,Mancos Canyon,Mancos Corrugated,4,920,1180,260,0,0,0
3217,Mancos Canyon,Mancos Gray,36,880,1060,180,0,1,0
3217,Mancos Canyon,"Mesa Verde Corrugated Gray Ware, Undifferentiated",68,920,1280,360,0,0,0
3217,Mancos Canyon,Mesa Verde Plain Gray,221,575,1020,445,0,0,0
3217,Mancos Canyon,Moccasin Gray,26,800,980,180,0,1,0
3217,Mancos Canyon,Piedra Black-on-white,21,800,920,120,1,1,1
3217,Mancos Canyon,"San Juan Red ware, Undifferentiated",9,700,1050,350,0,0,1
3217,Mancos Canyon,"White ware, Undifferentiated",77,550,1900,1350,0,0,1
3218,Martin Site 1,Bluff Black-on-red,2,800,925,125,1,1,1
3218,Martin Site 1,Mesa Verde Plain Gray,90,575,1020,445,0,0,0
3218,Martin Site 1,Moccasin Gray,5,800,980,180,0,1,0
3219,May Canyon,Chapin Black-on-white,2,575,880,305,0,1,1
3219,May Canyon,Chapin Gray,28,575,980,405,0,0,0
3219,May Canyon,Mancos Gray,12,880,1060,180,0,1,0
3219,May Canyon,"Mesa Verde Corrugated Gray Ware, Undifferentiated",1,920,1280,360,0,0,0
3219,May Canyon,"Mesa Verde PI White Ware, Type Undifferentiated",31,750,920,170,1,1,1
3219,May Canyon,Mesa Verde Plain Gray,834,575,1020,445,0,0,0
3219,May Canyon,Moccasin Gray,97,800,980,180,0,1,0
3219,May Canyon,Piedra Black-on-white,4,800,920,120,1,1,1
3219,May Canyon,"San Juan Red ware, Undifferentiated",21,700,1050,350,0,0,1
3221,McCreery,Adamana Brown,6,300,550,250,0,0,0
3221,McCreery,Black Mesa Black-on-white,9,1000,1100,100,1,1,1
3221,McCreery,Black Mesa/Sosi Black-on-white,36,1000,1180,180,1,1,1
3221,McCreery,"BMIII/PI White Ware, Type Undifferentiated",1,550,900,350,0,1,1
3221,McCreery,"Cibola BMIII/PI White Ware, Type Undifferentiated",1,550,900,350,0,1,1
3221,McCreery,"Cibola PII/PIII White Ware, Type Undifferentiated",17,1000,1300,300,1,1,1
3221,McCreery,"Cibola White Ware, Undifferentiated",114,550,1325,775,0,1,1
3221,McCreery,"Corrugated Gray Ware, Undifferentiated",1,800,1400,600,0,0,0
3221,McCreery,Dogoszhi Black-on-white,1,1040,1210,170,1,1,1
3221,McCreery,Escavada Black-on-white,25,1000,1100,100,1,1,1
3221,McCreery,Gallup Black-on-white,57,1040,1150,110,1,1,1
3221,McCreery,"Gray Ware, Undifferentiated",1,400,1400,1000,0,0,0
3221,McCreery,Holbrook A Black-on-white,31,1050,1150,100,1,1,1
3221,McCreery,Holbrook B Black-on-white,59,1050,1150,100,1,1,1
3221,McCreery,Holbrook Black-on-white,102,1050,1150,100,1,1,1
3221,McCreery,"Indented Corrugated Gray Ware, Undifferentiated",1,950,1400,450,0,0,0
3221,McCreery,Kana-a Black-on-white,4,825,1000,175,1,1,1
3221,McCreery,Kiatuthlanna Black-on-white,8,850,925,75,1,1,1
3221,McCreery,Little Colorado Clapboard Corrugated Gray,130,900,1100,200,0,1,0
3221,McCreery,"Little Colorado Corrugated Gray Ware, Undifferentiated",35,1050,1250,200,0,1,0
3221,McCreery,"Little Colorado Gray Ware, Undifferentiated",68,850,1300,450,0,0,0
3221,McCreery,Little Colorado Indented Corrugated Gray,1136,1050,1300,250,0,0,0
3221,McCreery,Little Colorado Obliterated Corrugated Gray,95,1100,1300,200,0,1,0
3221,McCreery,"Little Colorado Plain Gray, Undifferentiated",194,550,1040,490,0,0,0
3221,McCreery,"Little Colorado White Ware, Undifferentiated",272,825,1250,425,0,1,1
3221,McCreery,"Mogollon Brown ware, Undifferentiated",1,900,1400,500,0,0,0
3221,McCreery,Mogollon Clapboard Corrugated Brown Ware,59,1000,1450,450,0,0,0
3221,McCreery,Mogollon Indented Corrugated Brown Ware,703,1000,1400,400,0,0,0
3221,McCreery,"Mogollon Indented Corrugated Brown Ware, Smudged",145,1000,1400,400,0,0,0
3221,McCreery,Mogollon Obliterated Corrugated Brown,53,1000,1400,400,0,0,0
3221,McCreery,"Mogollon Obliterated Corrugated Brown Ware, Smudged",1,1000,1400,400,0,0,0
3221,McCreery,Mogollon Patterned Corrugated Brown Ware,8,1000,1400,400,0,0,0
3221,McCreery,Mogollon Plain Brown Ware,222,300,1400,1100,0,0,0
3221,McCreery,"Mogollon Plain Brown Ware, Smudged",13,300,1400,1100,0,0,0
3221,McCreery,Mogollon Plain Corrugated Brown Ware,11,900,1400,500,0,0,0
3221,McCreery,"Mogollon Plain Corrugated Brown Ware, Smudged",2,900,1400,500,0,0,0
3221,McCreery,Padre Black-on-white,1,1100,1250,150,1,1,1
3221,McCreery,"Plain Brown Ware, Undifferentiated",1,400,1450,1050,0,0,0
3221,McCreery,"Plain Gray Ware, Undifferentiated",2,500,1300,800,0,0,0
3221,McCreery,Puerco Black-on-white,2,1030,1200,170,1,1,1
3221,McCreery,"Puerco Valley Corrugated Gray Ware, Undifferentiated",16,800,1300,500,0,0,0
3221,McCreery,Red Mesa Black-on-white,12,880,1040,160,1,1,1
3221,McCreery,"Red Ware type, Undifferentiated",4,700,1700,1000,0,0,0
3221,McCreery,Reserve Black-on-white,11,1050,1200,150,1,1,1
3221,McCreery,Showlow Black-on-red,189,1030,1200,170,1,1,1
3221,McCreery,Showlow Red,231,1000,1100,100,0,1,0
3221,McCreery,Showlow Red Corrugated,45,1030,1280,250,0,0,0
3221,McCreery,Snowflake Black-on-white,3,1100,1275,175,1,1,1
3221,McCreery,Sosi Black-on-white,32,1070,1180,110,1,1,1
3221,McCreery,Tusayan Corrugated,13,1020,1275,255,0,0,0
3221,McCreery,"Tusayan Gray Ware, Undifferentiated",3,550,1285,735,0,0,0
3221,McCreery,"Tusayan PII/PIII White Ware, Type Undifferentiated",3,900,1300,400,0,1,1
3221,McCreery,Tusayan Plain Gray,6,600,1300,700,0,0,0
3221,McCreery,"Tusayan White Ware, Undifferentiated",39,825,1300,475,0,1,1
3221,McCreery,"Type, Undifferentiated",5,200,1900,1700,0,0,0
3221,McCreery,Walnut Black-on-white,1,1100,1250,150,1,1,1
3221,McCreery,"White Mountain type, Type Undifferentiated; Early",1,1000,1300,300,0,0,1
3221,McCreery,"White ware, Undifferentiated",303,550,1900,1350,0,0,1
3221,McCreery,Woodruff Brown,101,500,1100,600,0,0,0
3221,McCreery,Woodruff Smudged,391,500,1100,600,0,0,0
3224,Mesa Tierra,"Chuska Corrugated Gray Ware, Undifferentiated",6,890,1300,410,0,0,0
3224,Mesa Tierra,"Cibola Black-on-white, Undifferentiated",5,550,1325,775,0,1,1
3224,Mesa Tierra,"Cibola Corrugated Gray Ware, Undifferentiated",96,900,1400,500,0,0,0
3224,Mesa Tierra,Escavada Black-on-white,1,1000,1100,100,1,1,1
3224,Mesa Tierra,Gallup Black-on-white,4,1040,1150,110,1,1,1
3224,Mesa Tierra,Kwakina Polychrome,1,1280,1450,170,1,1,1
3224,Mesa Tierra,McElmo Black-on-white,6,1060,1260,200,1,1,1
3224,Mesa Tierra,Mesa Verde Black-on-white,12,1180,1280,100,1,1,1
3224,Mesa Tierra,"Mesa Verde Corrugated Gray Ware, Undifferentiated",2,920,1280,360,0,0,0
3224,Mesa Tierra,"Mesa Verde White Ware, Undifferentiated",4,575,1280,705,0,1,1
3224,Mesa Tierra,Puerco Black-on-red,4,1000,1175,175,1,1,1
3224,Mesa Tierra,Red Mesa Black-on-white,3,880,1040,160,1,1,1
3224,Mesa Tierra,St. Johns Polychrome,1,1200,1300,100,1,1,1
3224,Mesa Tierra,"White Mountain type, Type Undifferentiated; Early",10,1000,1300,300,0,0,1
3224,Mesa Tierra,Wingate Black-on-red,5,1050,1225,175,1,1,1
3224,Mesa Tierra,Wingate Polychrome,1,1100,1225,125,1,1,1
3225,Millard,Abajo Red-on-orange,1,760,880,120,1,1,1
3225,Millard,Bluff Black-on-red,7,800,925,125,1,1,1
3225,Millard,Chapin Gray,24,575,980,405,0,0,0
3225,Millard,Cortez Black-on-white,2,880,1060,180,1,1,1
3225,Millard,Dolores Corrugated,1,1100,1200,100,0,1,0
3225,Millard,"Gray Ware, Undifferentiated",2,400,1400,1000,0,0,0
3225,Millard,Mancos Gray,5,880,1060,180,0,1,0
3225,Millard,"Mesa Verde Corrugated Gray Ware, Undifferentiated",22,920,1280,360,0,0,0
3225,Millard,"Mesa Verde PII/PIII White Ware, Type Undifferentiated",2,920,1280,360,0,1,1
3225,Millard,Mesa Verde Plain Gray,408,575,1020,445,0,0,0
3225,Millard,Moccasin Gray,29,800,980,180,0,1,0
3225,Millard,Piedra Black-on-white,3,800,920,120,1,1,1
3225,Millard,"San Juan Red ware, Undifferentiated",3,700,1050,350,0,0,1
3225,Millard,"White ware, Undifferentiated",18,550,1900,1350,0,0,1
3226,Mineral Creek,Alma Neck Banded,17,665,910,245,0,0,0
3226,Mineral Creek,Alma Plain,1284,300,1000,700,0,0,0
3226,Mineral Creek,Alma Scored,1,300,1000,700,0,0,0
3226,Mineral Creek,"Black-on-red, Undifferentiated",88,700,1700,1000,0,1,1
3226,Mineral Creek,"Corrugated Gray Ware, Undifferentiated",75,800,1400,600,0,0,0
3226,Mineral Creek,"Indented Corrugated Gray Ware, Undifferentiated",73,950,1400,450,0,0,0
3226,Mineral Creek,Kiatuthlanna Black-on-white,42,850,925,75,1,1,1
3226,Mineral Creek,McDonald Corrugated,146,1150,1280,130,1,1,1
3226,Mineral Creek,"Mogollon Corrugated Brown Ware, Undifferentiated",3,800,1400,600,0,0,0
3226,Mineral Creek,Mogollon Indented Corrugated Brown Ware,1590,1000,1400,400,0,0,0
3226,Mineral Creek,"Mogollon Indented Corrugated Brown Ware, Smudged",377,1000,1400,400,0,0,0
3226,Mineral Creek,Mogollon Patterned Corrugated Brown Ware,97,1000,1400,400,0,0,0
3226,Mineral Creek,Mogollon Plain Corrugated Brown Ware,273,900,1400,500,0,0,0
3226,Mineral Creek,"Mogollon Plain Corrugated Brown Ware, Smudged",51,900,1400,500,0,0,0
3226,Mineral Creek,Puerco Black-on-white,7,1030,1200,170,1,1,1
3226,Mineral Creek,Red Mesa Black-on-white,29,880,1040,160,1,1,1
3226,Mineral Creek,Reserve Black-on-white,199,1050,1200,150,1,1,1
3226,Mineral Creek,San Francisco Red,18,550,950,400,0,0,0
3226,Mineral Creek,Snowflake Black-on-white,366,1100,1275,175,1,1,1
3226,Mineral Creek,St. Johns Polychrome,1,1200,1300,100,1,1,1
3226,Mineral Creek,Three Circle Neck Corrugated,12,800,1000,200,0,1,0
3226,Mineral Creek,Three Circle Red-on-white,3,725,800,75,1,1,1
3226,Mineral Creek,Tularosa Black-on-white,126,1180,1300,120,1,1,1
3226,Mineral Creek,"Type, Undifferentiated",25,200,1900,1700,0,0,0
3226,Mineral Creek,White Mound Black-on-white,7,700,850,150,1,1,1
3226,Mineral Creek,"White ware, Undifferentiated",1926,550,1900,1350,0,0,1
3226,Mineral Creek,Wingate Black-on-red,38,1050,1225,175,1,1,1
3226,Mineral Creek,Wingate Polychrome,1,1100,1225,125,1,1,1
3226,Mineral Creek,Woodruff Smudged,9,500,1100,600,0,0,0
3227,Mitchell Springs,Abajo Red-on-orange,39,760,880,120,1,1,1
3227,Mitchell Springs,Bennett Gray,2,700,850,150,0,1,0
3227,Mitchell Springs,Bluff Black-on-red,118,800,925,125,1,1,1
3227,Mitchell Springs,Chaco Black-on-white,6,1075,1150,75,1,1,1
3227,Mitchell Springs,Chapin Black-on-white,61,575,880,305,0,1,1
3227,Mitchell Springs,Chapin Gray,52,575,980,405,0,0,0
3227,Mitchell Springs,Cortez Black-on-white,175,880,1060,180,1,1,1
3227,Mitchell Springs,Deadmans (La Plata) Black-on-red,17,880,1050,170,1,1,1
3227,Mitchell Springs,Dolores Corrugated,2,1100,1200,100,0,1,0
3227,Mitchell Springs,Hunter Corrugated,1,1100,1300,200,0,1,0
3227,Mitchell Springs,Kana-a Black-on-white,4,825,1000,175,1,1,1
3227,Mitchell Springs,Kiatuthlanna Black-on-white,1,850,925,75,1,1,1
3227,Mitchell Springs,Lino Black-on-gray (Tusayan),2,600,850,250,1,1,1
3227,Mitchell Springs,Lino Gray (Tusayan),1,550,950,400,0,0,0
3227,Mitchell Springs,Mancos Black-on-white,115,980,1180,200,1,1,1
3227,Mitchell Springs,Mancos Corrugated,45,920,1180,260,0,0,0
3227,Mitchell Springs,Mancos Gray,386,880,1060,180,0,1,0
3227,Mitchell Springs,McElmo Black-on-white,50,1060,1260,200,1,1,1
3227,Mitchell Springs,McElmo/Mesa Verde Black-on-white,38,1060,1280,220,1,1,1
3227,Mitchell Springs,Mesa Verde Black-on-white,12,1180,1280,100,1,1,1
3227,Mitchell Springs,Mesa Verde Corrugated,1,1100,1280,180,0,1,0
3227,Mitchell Springs,"Mesa Verde Corrugated Gray Ware, Undifferentiated",626,920,1280,360,0,0,0
3227,Mitchell Springs,"Mesa Verde Gray ware, Undifferentiated",2288,575,1280,705,0,0,0
3227,Mitchell Springs,Moccasin Gray,28,800,980,180,0,1,0
3227,Mitchell Springs,Piedra Black-on-white,22,800,920,120,1,1,1
3227,Mitchell Springs,Puerco Black-on-white,6,1030,1200,170,1,1,1
3227,Mitchell Springs,"Puerco Valley Brown Ware, Undifferentiated",1,400,1300,900,0,0,0
3227,Mitchell Springs,"Red Ware type, Undifferentiated",9,700,1700,1000,0,0,0
3227,Mitchell Springs,"San Juan Red ware, Undifferentiated",58,700,1050,350,0,0,1
3227,Mitchell Springs,Showlow Red,1,1000,1100,100,0,1,0
3227,Mitchell Springs,Tunicha Black-on-white,1,850,900,50,1,1,1
3227,Mitchell Springs,"Type, Undifferentiated",1,200,1900,1700,0,0,0
3227,Mitchell Springs,White Mesa Black-on-white,2,850,1000,150,1,1,1
3227,Mitchell Springs,"White ware, Undifferentiated",663,550,1900,1350,0,0,1
3228,Mitten Rock,Abajo Red-on-orange,6,760,880,120,1,1,1
3228,Mitten Rock,Bennett Gray,151,700,850,150,0,1,0
3228,Mitten Rock,Black Mesa Black-on-white,3,1000,1100,100,1,1,1
3228,Mitten Rock,Blue Shale Corrugated,348,925,1150,225,0,0,0
3228,Mitten Rock,Bluff Black-on-red,9,800,925,125,1,1,1
3228,Mitten Rock,Brimhall Black-on-white,14,1040,1150,110,1,1,1
3228,Mitten Rock,Burnham Black-on-white,30,860,1000,140,1,1,1
3228,Mitten Rock,Cameron Polychrome,3,1040,1170,130,1,1,1
3228,Mitten Rock,Captain Tom Corrugated,17,890,1000,110,0,1,0
3228,Mitten Rock,Chaco Black-on-white,1,1075,1150,75,1,1,1
3228,Mitten Rock,Chapin Gray,3,575,980,405,0,0,0
3228,Mitten Rock,Chuska Black-on-white,120,1040,1125,85,1,1,1
3228,Mitten Rock,"Chuska White Ware type, Undifferentiated",186,800,1300,500,0,1,1
3228,Mitten Rock,Cortez Black-on-white,1,880,1060,180,1,1,1
3228,Mitten Rock,Crozier Black-on-white,28,800,900,100,1,1,1
3228,Mitten Rock,Deadmans (La Plata) Black-on-red,28,880,1050,170,1,1,1
3228,Mitten Rock,Dogoszhi Black-on-white,1,1040,1210,170,1,1,1
3228,Mitten Rock,Drolet Black-on-white,3,900,1000,100,1,1,1
3228,Mitten Rock,Gallup Black-on-white,3,1040,1150,110,1,1,1
3228,Mitten Rock,Gray Hills Banded,23,850,950,100,0,1,0
3228,Mitten Rock,Hunter Corrugated,233,1100,1300,200,0,1,0
3228,Mitten Rock,Kana-a Black-on-white,8,825,1000,175,1,1,1
3228,Mitten Rock,Kiatuthlanna Black-on-white,1,850,925,75,1,1,1
3228,Mitten Rock,La Plata Black-on-white,1,550,750,200,1,1,1
3228,Mitten Rock,Lino Black-on-gray (Tusayan),1,600,850,250,1,1,1
3228,Mitten Rock,Lino Gray (Cibola),18,550,950,400,1,0,0
3228,Mitten Rock,Lino Gray (Tusayan),4,550,950,400,0,0,0
3228,Mitten Rock,Lino Gray Fugitive Red [Cibola Series],2,550,850,300,1,0,0
3228,Mitten Rock,Mancos Black-on-white,8,980,1180,200,1,1,1
3228,Mitten Rock,Mancos Corrugated,4,920,1180,260,0,0,0
3228,Mitten Rock,Mancos Gray,1,880,1060,180,0,1,0
3228,Mitten Rock,McElmo Black-on-white,3,1060,1260,200,1,1,1
3228,Mitten Rock,Mesa Verde Corrugated,2,1100,1280,180,0,1,0
3228,Mitten Rock,"Mesa Verde White Ware, Undifferentiated",3,575,1280,705,0,1,1
3228,Mitten Rock,Moenkopi Corrugated,3,1130,1250,120,0,1,0
3228,Mitten Rock,Naschitti Black-on-white,5,900,1000,100,1,1,1
3228,Mitten Rock,Nava Black-on-white,29,1100,1275,175,1,1,1
3228,Mitten Rock,Newcomb Black-on-white,118,875,1000,125,1,1,1
3228,Mitten Rock,Newcomb Corrugated,12,875,950,75,0,1,0
3228,Mitten Rock,Pena Black-on-white,23,800,900,100,1,1,1
3228,Mitten Rock,Red Mesa Black-on-white,10,880,1040,160,1,1,1
3228,Mitten Rock,"Red Ware type, Undifferentiated",8,700,1700,1000,0,0,0
3228,Mitten Rock,"San Juan Red ware, Undifferentiated",24,700,1050,350,0,0,1
3228,Mitten Rock,Sanostee Black-on-red,4,825,875,50,1,1,1
3228,Mitten Rock,Sanostee Red-on-Orange,5,825,875,50,1,1,1
3228,Mitten Rock,Sheep Springs Gray,38,800,850,50,0,1,0
3228,Mitten Rock,Taylor Black-on-white,3,1000,1100,100,1,1,1
3228,Mitten Rock,Theodore Black-on-white,10,800,825,25,1,1,1
3228,Mitten Rock,Toadlena Black-on-white,77,975,1125,150,1,1,1
3228,Mitten Rock,Tocito Gray,30,825,875,50,0,1,0
3228,Mitten Rock,"Tsegi Orange Ware, Undifferentiated",4,1000,1300,300,1,0,1
3228,Mitten Rock,Tunicha Black-on-white,16,850,900,50,1,1,1
3228,Mitten Rock,Tusayan Black-on-red,6,1045,1240,195,1,1,1
3228,Mitten Rock,Tusayan Black-on-white,1,1200,1300,100,1,1,1
3228,Mitten Rock,Tusayan Corrugated,15,1020,1275,255,0,0,0
3228,Mitten Rock,"Type, Undifferentiated",8,200,1900,1700,0,0,0
3228,Mitten Rock,Wetherill Black-on-white,6,1060,1180,120,1,1,1
3228,Mitten Rock,White Mound Black-on-white,1,700,850,150,1,1,1
3228,Mitten Rock,"White ware, Undifferentiated",18,550,1900,1350,0,0,1
3232,Montezuma Village North,Abajo Polychrome,1,850,925,75,1,1,1
3232,Montezuma Village North,Abajo Red-on-orange,3,760,880,120,1,1,1
3232,Montezuma Village North,Bluff Black-on-red,4,800,925,125,1,1,1
3232,Montezuma Village North,Chapin Gray,1,575,980,405,0,0,0
3232,Montezuma Village North,"Corrugated Gray Ware, Undifferentiated",359,800,1400,600,0,0,0
3232,Montezuma Village North,Cortez Black-on-white,2,880,1060,180,1,1,1
3232,Montezuma Village North,Deadmans (La Plata) Black-on-red,1,880,1050,170,1,1,1
3232,Montezuma Village North,Dolores Corrugated,22,1100,1200,100,0,1,0
3232,Montezuma Village North,Mancos Black-on-white,154,980,1180,200,1,1,1
3232,Montezuma Village North,Mancos Corrugated,8,920,1180,260,0,0,0
3232,Montezuma Village North,Mancos Gray,5,880,1060,180,0,1,0
3232,Montezuma Village North,McElmo Black-on-white,79,1060,1260,200,1,1,1
3232,Montezuma Village North,Medicine Black-on-red,1,1040,1170,130,1,1,1
3232,Montezuma Village North,Mesa Verde Black-on-white,288,1180,1280,100,1,1,1
3232,Montezuma Village North,Mesa Verde Corrugated,7,1100,1280,180,0,1,0
3232,Montezuma Village North,"Mesa Verde Corrugated Gray Ware, Undifferentiated",487,920,1280,360,0,0,0
3232,Montezuma Village North,"Mesa Verde PII/PIII White Ware, Type Undifferentiated",34,920,1280,360,0,1,1
3232,Montezuma Village North,"Mesa Verde White Ware, Undifferentiated",435,575,1280,705,0,1,1
3232,Montezuma Village North,Moccasin Gray,1,800,980,180,0,1,0
3232,Montezuma Village North,Piedra Black-on-white,2,800,920,120,1,1,1
3232,Montezuma Village North,"PII/PIII White Ware, Type Undifferentiated",62,900,1300,400,0,1,1
3232,Montezuma Village North,"Plain Gray Ware, Undifferentiated",48,500,1300,800,0,0,0
3232,Montezuma Village North,"San Juan Red ware, Undifferentiated",9,700,1050,350,0,0,1
3232,Montezuma Village North,Sosi Black-on-white,1,1070,1180,110,1,1,1
3232,Montezuma Village North,"Tsegi Orange Ware, Undifferentiated",1,1000,1300,300,1,0,1
3233,Montezuma Village South,Bluff Black-on-red,1,800,925,125,1,1,1
3233,Montezuma Village South,Chapin Black-on-white,1,575,880,305,0,1,1
3233,Montezuma Village South,"Corrugated Gray Ware, Undifferentiated",367,800,1400,600,0,0,0
3233,Montezuma Village South,Deadmans (La Plata) Black-on-red,2,880,1050,170,1,1,1
3233,Montezuma Village South,Dolores Corrugated,3,1100,1200,100,0,1,0
3233,Montezuma Village South,Mancos Black-on-white,152,980,1180,200,1,1,1
3233,Montezuma Village South,Mancos Corrugated,38,920,1180,260,0,0,0
3233,Montezuma Village South,Mancos Gray,6,880,1060,180,0,1,0
3233,Montezuma Village South,McElmo Black-on-white,44,1060,1260,200,1,1,1
3233,Montezuma Village South,Mesa Verde Black-on-white,74,1180,1280,100,1,1,1
3233,Montezuma Village South,Mesa Verde Corrugated,4,1100,1280,180,0,1,0
3233,Montezuma Village South,"Mesa Verde PIII White Ware, Type Undifferentiated",180,1100,1280,180,1,1,1
3233,Montezuma Village South,"Numic Brown Ware, Undifferentiated",1,1000,1850,850,0,0,0
3233,Montezuma Village South,"PII/PIII Gray Rim, Type Undifferentiated",18,900,1300,400,0,0,0
3233,Montezuma Village South,"Plain Gray Ware, Undifferentiated",31,500,1300,800,0,0,0
3233,Montezuma Village South,"San Juan Red ware, Undifferentiated",3,700,1050,350,0,0,1
3233,Montezuma Village South,"Tsegi Orange Ware, Undifferentiated",3,1000,1300,300,1,0,1
3233,Montezuma Village South,"Type, Undifferentiated",1,200,1900,1700,0,0,0
3233,Montezuma Village South,"White ware, Undifferentiated",53,550,1900,1350,0,0,1
3234,Morefield,Abajo Red-on-orange,1,760,880,120,1,1,1
3234,Morefield,Bluff Black-on-red,2,800,925,125,1,1,1
3234,Morefield,Cortez Black-on-white,30,880,1060,180,1,1,1
3234,Morefield,Deadmans (La Plata) Black-on-red,2,880,1050,170,1,1,1
3234,Morefield,Mancos Black-on-white,92,980,1180,200,1,1,1
3234,Morefield,Mancos Corrugated,18,920,1180,260,0,0,0
3234,Morefield,Mancos Gray,45,880,1060,180,0,1,0
3234,Morefield,McElmo Black-on-white,8,1060,1260,200,1,1,1
3234,Morefield,Mesa Verde Black-on-white,2,1180,1280,100,1,1,1
3234,Morefield,"Mesa Verde BMIII/PI White Ware, Type Undifferentiated",311,575,920,345,0,1,1
3234,Morefield,Mesa Verde Corrugated,3,1100,1280,180,0,1,0
3234,Morefield,"Mesa Verde Corrugated Gray Ware, Undifferentiated",490,920,1280,360,0,0,0
3234,Morefield,"Mesa Verde PII White Ware, Type Undifferentiated",132,920,1100,180,1,1,1
3234,Morefield,"Mesa Verde PII/PIII White Ware, Type Undifferentiated",391,920,1280,360,0,1,1
3234,Morefield,"Mesa Verde PIII White Ware, Type Undifferentiated",3,1100,1280,180,1,1,1
3234,Morefield,Mesa Verde Plain Gray,98,575,1020,445,0,0,0
3234,Morefield,Moccasin Gray,38,800,980,180,0,1,0
3234,Morefield,Piedra Black-on-white,16,800,920,120,1,1,1
3234,Morefield,"Red Ware type, Undifferentiated",6,700,1700,1000,0,0,0
3240,Muddy Water,Chaco-McElmo Black-on-white (carbon paint),1,1090,1175,85,1,1,1
3240,Muddy Water,"Cibola Corrugated Gray Ware, Undifferentiated",1,900,1400,500,0,0,0
3240,Muddy Water,Cibola Indented Corrugated Gray,57,1040,1400,360,0,0,0
3240,Muddy Water,Cibola Neckbanded Gray,5,850,1025,175,0,1,0
3240,Muddy Water,Cibola Plain Gray,59,550,1040,490,0,0,0
3240,Muddy Water,"Cibola White Ware, Undifferentiated",43,550,1325,775,0,1,1
3240,Muddy Water,Escavada-Puerco Black-on-white,5,1000,1100,100,1,1,1
3240,Muddy Water,Gallup Black-on-white,11,1040,1150,110,1,1,1
3240,Muddy Water,Red Mesa Black-on-white,18,880,1040,160,1,1,1
3240,Muddy Water,Socorro Black-on-white,1,1050,1300,250,1,1,1
3240,Muddy Water,White Mound Black-on-white,1,700,850,150,1,1,1
3241,NA 8800,Abajo Polychrome,1,850,925,75,1,1,1
3241,NA 8800,Abajo Red-on-orange,16,760,880,120,1,1,1
3241,NA 8800,Black Mesa Black-on-white,80,1000,1100,100,1,1,1
3241,NA 8800,Bluff Black-on-red,8,800,925,125,1,1,1
3241,NA 8800,Deadmans (La Plata) Black-on-red,17,880,1050,170,1,1,1
3241,NA 8800,Dogoszhi Black-on-white,136,1040,1210,170,1,1,1
3241,NA 8800,Holbrook Black-on-white,3,1050,1150,100,1,1,1
3241,NA 8800,Kana-a Black-on-white,47,825,1000,175,1,1,1
3241,NA 8800,Kana'a Gray Ware,7,865,1060,195,0,1,0
3241,NA 8800,Kayenta Black-on-white,1,1250,1300,50,1,1,1
3241,NA 8800,Lino Black-on-gray (Tusayan),412,600,850,250,1,1,1
3241,NA 8800,Lino Gray (Tusayan),15123,550,950,400,0,0,0
3241,NA 8800,"Little Colorado White Ware, Undifferentiated",76,825,1250,425,0,1,1
3241,NA 8800,Medicine Black-on-red,1,1040,1170,130,1,1,1
3241,NA 8800,Moenkopi Corrugated,74,1130,1250,120,0,1,0
3241,NA 8800,"San Juan Red ware, Undifferentiated",312,700,1050,350,0,0,1
3241,NA 8800,Shato Black-on-white,7,1025,1150,125,1,1,1
3241,NA 8800,Sosi Black-on-white,134,1070,1180,110,1,1,1
3241,NA 8800,Tallohogan Red,8,620,875,255,0,0,0
3241,NA 8800,"Tsegi Orange Ware, Undifferentiated",417,1000,1300,300,1,0,1
3241,NA 8800,Tusayan Black-on-red,55,1045,1240,195,1,1,1
3241,NA 8800,Tusayan Black-on-white,1,1200,1300,100,1,1,1
3241,NA 8800,"Tusayan BMIII/PI White Ware, Type Undifferentiated",2,600,900,300,1,1,1
3241,NA 8800,Tusayan Corrugated,3978,1020,1275,255,0,0,0
3241,NA 8800,"Tusayan Gray Ware, Undifferentiated",209,550,1285,735,0,0,0
3241,NA 8800,Tusayan Polychrome,1,1110,1320,210,1,1,1
3241,NA 8800,"Tusayan White Ware, Undifferentiated",1140,825,1300,475,0,1,1
3241,NA 8800,"Type, Undifferentiated",23,200,1900,1700,0,0,0
3248,Navajo Springs,Black Mesa Black-on-white,12,1000,1100,100,1,1,1
3248,Navajo Springs,"Cibola Gray Ware, Undifferentiated",314,550,1400,850,0,0,0
3248,Navajo Springs,"Cibola White Ware, Undifferentiated",120,550,1325,775,0,1,1
3248,Navajo Springs,"Decorated Type, Undifferentiated",34,300,1900,1600,0,0,1
3248,Navajo Springs,Escavada Black-on-white,196,1000,1100,100,1,1,1
3248,Navajo Springs,Gallup Black-on-white,196,1040,1150,110,1,1,1
3248,Navajo Springs,"Gray Ware, Undifferentiated",280,400,1400,1000,0,0,0
3248,Navajo Springs,Holbrook B Black-on-white,12,1050,1150,100,1,1,1
3248,Navajo Springs,"Little Colorado Corrugated Gray Ware, Undifferentiated",18,1050,1250,200,0,1,0
3248,Navajo Springs,"Little Colorado Gray Ware, Undifferentiated",24,850,1300,450,0,0,0
3248,Navajo Springs,"Little Colorado White Ware, Undifferentiated",14,825,1250,425,0,1,1
3248,Navajo Springs,Puerco Black-on-red,10,1000,1175,175,1,1,1
3248,Navajo Springs,Puerco Black-on-white,10,1030,1200,170,1,1,1
3248,Navajo Springs,"Puerco Valley Gray Ware, Undifferentiated",716,400,1300,900,0,0,0
3248,Navajo Springs,Red Mesa Black-on-white,42,880,1040,160,1,1,1
3248,Navajo Springs,Showlow Black-on-red,12,1030,1200,170,1,1,1
3248,Navajo Springs,Showlow Red,114,1000,1100,100,0,1,0
3248,Navajo Springs,Showlow Red Corrugated,8,1030,1280,250,0,0,0
3248,Navajo Springs,Sosi Black-on-white,12,1070,1180,110,1,1,1
3248,Navajo Springs,"Tusayan White Ware, Undifferentiated",28,825,1300,475,0,1,1
3248,Navajo Springs,"Type, Undifferentiated",22,200,1900,1700,0,0,0
3248,Navajo Springs,"Undecorated Type, Undifferentiated",20,200,1900,1700,0,0,0
3248,Navajo Springs,Wingate Black-on-red,16,1050,1225,175,1,1,1
3248,Navajo Springs,Woodruff Brown,246,500,1100,600,0,0,0
3248,Navajo Springs,Woodruff Smudged,20,500,1100,600,0,0,0
3249,Navajo Territorial Gov't Complex,"Cibola Black-on-white, Undifferentiated",6,550,1325,775,0,1,1
3249,Navajo Territorial Gov't Complex,"Cibola Gray Ware, Undifferentiated",8,550,1400,850,0,0,0
3249,Navajo Territorial Gov't Complex,Cibola Plain Gray,44,550,1040,490,0,0,0
3249,Navajo Territorial Gov't Complex,Kana-a Black-on-white,14,825,1000,175,1,1,1
3249,Navajo Territorial Gov't Complex,Kiatuthlanna Black-on-white,32,850,925,75,1,1,1
3249,Navajo Territorial Gov't Complex,Lino Gray (Cibola),4,550,950,400,1,0,0
3249,Navajo Territorial Gov't Complex,"Plain Gray Ware, Undifferentiated",8,500,1300,800,0,0,0
3249,Navajo Territorial Gov't Complex,"Puerco Valley Corrugated Gray Ware, Undifferentiated",2,800,1300,500,0,0,0
3249,Navajo Territorial Gov't Complex,"Puerco Valley Gray Ware, Undifferentiated",38,400,1300,900,0,0,0
3249,Navajo Territorial Gov't Complex,Red Mesa Black-on-white,12,880,1040,160,1,1,1
3249,Navajo Territorial Gov't Complex,"San Juan Red ware, Undifferentiated",4,700,1050,350,0,0,1
3249,Navajo Territorial Gov't Complex,Tusayan Clapboard Corrugated,4,1030,1100,70,0,1,0
3249,Navajo Territorial Gov't Complex,"Tusayan Gray Ware, Undifferentiated",22,550,1285,735,0,0,0
3249,Navajo Territorial Gov't Complex,Tusayan Plain Gray,68,600,1300,700,0,0,0
3249,Navajo Territorial Gov't Complex,"Tusayan White Ware, Undifferentiated",2,825,1300,475,0,1,1
3249,Navajo Territorial Gov't Complex,White Mound Black-on-white,2,700,850,150,1,1,1
3249,Navajo Territorial Gov't Complex,"White ware, Undifferentiated",88,550,1900,1350,0,0,1
3249,Navajo Territorial Gov't Complex,Woodruff Brown,6,500,1100,600,0,0,0
3249,Navajo Territorial Gov't Complex,Woodruff Smudged,2,500,1100,600,0,0,0
3251,North Lowry,Deadmans (La Plata) Black-on-red,1,880,1050,170,1,1,1
3251,North Lowry,Mancos Black-on-white,11,980,1180,200,1,1,1
3251,North Lowry,Mancos Corrugated,7,920,1180,260,0,0,0
3251,North Lowry,Mancos Gray,1,880,1060,180,0,1,0
3251,North Lowry,McElmo Black-on-white,2,1060,1260,200,1,1,1
3251,North Lowry,"Mesa Verde BMIII/PI White Ware, Type Undifferentiated",3,575,920,345,0,1,1
3251,North Lowry,"Mesa Verde Corrugated Gray Ware, Undifferentiated",185,920,1280,360,0,0,0
3251,North Lowry,"Mesa Verde PII White Ware, Type Undifferentiated",12,920,1100,180,1,1,1
3251,North Lowry,"Mesa Verde PII/PIII White Ware, Type Undifferentiated",127,920,1280,360,0,1,1
3251,North Lowry,"Mesa Verde PIII White Ware, Type Undifferentiated",8,1100,1280,180,1,1,1
3251,North Lowry,Mesa Verde Plain Gray,26,575,1020,445,0,0,0
3251,North Lowry,Moccasin Gray,4,800,980,180,0,1,0
3252,Oak Wash--Zuni,Cibola Indented Corrugated Gray,446,1040,1400,360,0,0,0
3252,Oak Wash--Zuni,Cibola Neckbanded Gray,3,850,1025,175,0,1,0
3252,Oak Wash--Zuni,Cibola Plain Corrugated Gray,15,900,1100,200,0,1,0
3252,Oak Wash--Zuni,Escavada Black-on-white,127,1000,1100,100,1,1,1
3252,Oak Wash--Zuni,Gallup Black-on-white,93,1040,1150,110,1,1,1
3252,Oak Wash--Zuni,Puerco Black-on-red,4,1000,1175,175,1,1,1
3252,Oak Wash--Zuni,Red Mesa Black-on-white,4,880,1040,160,1,1,1
3252,Oak Wash--Zuni,Reserve Black-on-white,27,1050,1200,150,1,1,1
3253,Owen Site,Black Mesa Black-on-white,13,1000,1100,100,1,1,1
3253,Owen Site,Cameron Polychrome,5,1040,1170,130,1,1,1
3253,Owen Site,Citadel Polychrome,12,1040,1200,160,1,1,1
3253,Owen Site,Dogoszhi Black-on-white,9,1040,1210,170,1,1,1
3253,Owen Site,"Gray Ware, Undifferentiated",4,400,1400,1000,0,0,0
3253,Owen Site,Kana-a Black-on-white,1,825,1000,175,1,1,1
3253,Owen Site,Mancos Black-on-white,52,980,1180,200,1,1,1
3253,Owen Site,McElmo/Mesa Verde Black-on-white,24,1060,1280,220,1,1,1
3253,Owen Site,Medicine Black-on-red,1,1040,1170,130,1,1,1
3253,Owen Site,"Mesa Verde Corrugated Gray Ware, Undifferentiated",382,920,1280,360,0,0,0
3253,Owen Site,"Mesa Verde White Ware, Undifferentiated",154,575,1280,705,0,1,1
3253,Owen Site,"Red Ware type, Undifferentiated",1,700,1700,1000,0,0,0
3253,Owen Site,"San Juan Red ware, Undifferentiated",4,700,1050,350,0,0,1
3253,Owen Site,Sosi Black-on-white,70,1070,1180,110,1,1,1
3253,Owen Site,"Tsegi Orange Ware, Undifferentiated",86,1000,1300,300,1,0,1
3253,Owen Site,Tusayan Black-on-red,17,1045,1240,195,1,1,1
3253,Owen Site,Tusayan Polychrome,9,1110,1320,210,1,1,1
3253,Owen Site,"Tusayan White Ware, Undifferentiated",66,825,1300,475,0,1,1
3253,Owen Site,Tusayan/Moenkopi Corrugated,605,1020,1320,300,0,0,0
3253,Owen Site,"White ware, Undifferentiated",13,550,1900,1350,0,0,1
3254,Padilla Well,Abajo Red-on-orange,1,760,880,120,1,1,1
3254,Padilla Well,Bennett Gray,1,700,850,150,0,1,0
3254,Padilla Well,Black Mesa Black-on-white,3,1000,1100,100,1,1,1
3254,Padilla Well,Blue Shale Corrugated,26,925,1150,225,0,0,0
3254,Padilla Well,Bluff Black-on-red,1,800,925,125,1,1,1
3254,Padilla Well,Brimhall Black-on-white,1,1040,1150,110,1,1,1
3254,Padilla Well,Burnham/Newcomb Black-on-white,5,860,1000,140,1,1,1
3254,Padilla Well,Captain Tom Corrugated,42,890,1000,110,0,1,0
3254,Padilla Well,Chaco Black-on-white,17,1075,1150,75,1,1,1
3254,Padilla Well,Chaco-McElmo Black-on-white (carbon paint),41,1090,1175,85,1,1,1
3254,Padilla Well,Chuska Black-on-white,11,1040,1125,85,1,1,1
3254,Padilla Well,"Chuska Carbon Painted White Ware, Undifferentiated",20,800,1300,500,0,1,1
3254,Padilla Well,"Chuska Corrugated Gray Ware, Undifferentiated",21,890,1300,410,0,0,0
3254,Padilla Well,Chuska Indented Corrugated Gray,397,1040,1300,260,0,0,0
3254,Padilla Well,Chuska Neck Indented Corrugated Gray,7,950,1025,75,0,1,0
3254,Padilla Well,"Chuska Plain Gray Ware, Type Undifferentiated",58,700,925,225,0,0,0
3254,Padilla Well,"Chuska White Ware type, Undifferentiated",27,800,1300,500,0,1,1
3254,Padilla Well,"Cibola BMIII/PI White Ware, Type Undifferentiated",12,550,900,350,0,1,1
3254,Padilla Well,"Cibola Gray Ware, Undifferentiated",23,550,1400,850,0,0,0
3254,Padilla Well,Cibola Indented Corrugated Gray,519,1040,1400,360,0,0,0
3254,Padilla Well,Cibola Narrow Neckbanded Gray,71,900,1025,125,0,1,0
3254,Padilla Well,Cibola Neck Indented Corrugated,5,950,1025,75,0,1,0
3254,Padilla Well,Cibola Neckbanded Gray,5,850,1025,175,0,1,0
3254,Padilla Well,"Cibola PII Gray Ware, Type Undifferentiated",8,950,1100,150,0,1,0
3254,Padilla Well,"Cibola PII/PIII Gray Ware, Type Undifferentiated",7,950,1300,350,0,0,0
3254,Padilla Well,"Cibola PII/PIII White Ware, Type Undifferentiated",259,1000,1300,300,1,1,1
3254,Padilla Well,Cibola Plain Gray,336,550,1040,490,0,0,0
3254,Padilla Well,"Cibola White Ware, Undifferentiated",16,550,1325,775,0,1,1
3254,Padilla Well,Cibola Wide Neckbanded,22,850,925,75,0,1,0
3254,Padilla Well,Crozier Black-on-white,2,800,900,100,1,1,1
3254,Padilla Well,Deadmans (La Plata) Black-on-red,3,880,1050,170,1,1,1
3254,Padilla Well,Escavada Black-on-white,10,1000,1100,100,1,1,1
3254,Padilla Well,Escavada-Puerco Black-on-white,78,1000,1100,100,1,1,1
3254,Padilla Well,Gallup Black-on-white,290,1040,1150,110,1,1,1
3254,Padilla Well,Kiatuthlanna Black-on-white,98,850,925,75,1,1,1
3254,Padilla Well,La Plata Black-on-white,4,550,750,200,1,1,1
3254,Padilla Well,Lino Black-on-gray (Tusayan),1,600,850,250,1,1,1
3254,Padilla Well,Lino Gray (Cibola),17,550,950,400,1,0,0
3254,Padilla Well,Lino Gray (Tusayan),5,550,950,400,0,0,0
3254,Padilla Well,Nava Black-on-white,3,1100,1275,175,1,1,1
3254,Padilla Well,Pena Black-on-white,1,800,900,100,1,1,1
3254,Padilla Well,Puerco Black-on-red,7,1000,1175,175,1,1,1
3254,Padilla Well,Red Mesa Black-on-white,183,880,1040,160,1,1,1
3254,Padilla Well,"San Juan Red ware, Undifferentiated",11,700,1050,350,0,0,1
3254,Padilla Well,Sanostee Black-on-red,1,825,875,50,1,1,1
3254,Padilla Well,Sheep Springs/Tocito Gray,5,800,875,75,0,1,0
3254,Padilla Well,Showlow Black-on-red,2,1030,1200,170,1,1,1
3254,Padilla Well,St. Johns Black-on-red,1,1200,1300,100,1,1,1
3254,Padilla Well,Toadlena Black-on-white,8,975,1125,150,1,1,1
3254,Padilla Well,"Tsegi Orange Ware, Undifferentiated",1,1000,1300,300,1,0,1
3254,Padilla Well,Tunicha Black-on-white,5,850,900,50,1,1,1
3254,Padilla Well,Tusayan Black-on-red,1,1045,1240,195,1,1,1
3254,Padilla Well,"Tusayan White Ware, Undifferentiated",1,825,1300,475,0,1,1
3254,Padilla Well,White Mound Black-on-white,8,700,850,150,1,1,1
3254,Padilla Well,"White Mountain type, Type Undifferentiated; Early",6,1000,1300,300,0,0,1
3254,Padilla Well,"White ware, Undifferentiated",458,550,1900,1350,0,0,1
3254,Padilla Well,Wingate Black-on-red,2,1050,1225,175,1,1,1
3254,Padilla Well,Woodruff Brown,6,500,1100,600,0,0,0
3255,Parker Site,Bluff Black-on-red,8,800,925,125,1,1,1
3255,Parker Site,Chapin Gray,1,575,980,405,0,0,0
3255,Parker Site,Cortez Black-on-white,1,880,1060,180,1,1,1
3255,Parker Site,Deadmans (La Plata) Black-on-red,16,880,1050,170,1,1,1
3255,Parker Site,Mancos Black-on-white,2,980,1180,200,1,1,1
3255,Parker Site,Mancos Corrugated,6,920,1180,260,0,0,0
3255,Parker Site,Mancos Gray,42,880,1060,180,0,1,0
3255,Parker Site,"Mesa Verde Corrugated Gray Ware, Undifferentiated",1,920,1280,360,0,0,0
3255,Parker Site,"Mesa Verde Gray ware, Undifferentiated",300,575,1280,705,0,0,0
3255,Parker Site,"Mesa Verde PI/PII White Ware, Type Undifferentiated",1,750,1180,430,0,1,1
3255,Parker Site,Moccasin Gray,4,800,980,180,0,1,0
3255,Parker Site,"San Juan Red ware, Undifferentiated",6,700,1050,350,0,0,1
3255,Parker Site,White Mesa Black-on-white,11,850,1000,150,1,1,1
3256,Peach Springs,Brimhall Black-on-white,1,1040,1150,110,1,1,1
3256,Peach Springs,Captain Tom Corrugated,1,890,1000,110,0,1,0
3256,Peach Springs,Chaco Black-on-white,1,1075,1150,75,1,1,1
3256,Peach Springs,Chuska Black-on-white,1,1040,1125,85,1,1,1
3256,Peach Springs,"Chuska Gray Ware, Type Undifferentiated",6,700,1300,600,0,0,0
3256,Peach Springs,Chuska Indented Corrugated Gray,9,1040,1300,260,0,0,0
3256,Peach Springs,"Chuska Mineral Painted White Ware, Undifferentiated",1,800,1300,500,0,1,1
3256,Peach Springs,Chuska Neckbanded,1,800,950,150,0,1,0
3256,Peach Springs,"Chuska Orange Ware, Undifferentiated",1,825,875,50,1,1,1
3256,Peach Springs,"Chuska White Ware type, Undifferentiated",2,800,1300,500,0,1,1
3256,Peach Springs,"Cibola Black-on-white, Undifferentiated",12,550,1325,775,0,1,1
3256,Peach Springs,Cibola Clapboard Corrugated Gray,1,900,1100,200,0,1,0
3256,Peach Springs,"Cibola Gray Ware, Undifferentiated",198,550,1400,850,0,0,0
3256,Peach Springs,Cibola Indented Corrugated Gray,28,1040,1400,360,0,0,0
3256,Peach Springs,Cibola Neckbanded Gray,6,850,1025,175,0,1,0
3256,Peach Springs,"Cibola White Ware, Undifferentiated",46,550,1325,775,0,1,1
3256,Peach Springs,Escavada Black-on-white,10,1000,1100,100,1,1,1
3256,Peach Springs,Gallup Black-on-white,11,1040,1150,110,1,1,1
3256,Peach Springs,Kiatuthlanna Black-on-white,3,850,925,75,1,1,1
3256,Peach Springs,Naschitti Black-on-white,1,900,1000,100,1,1,1
3256,Peach Springs,Puerco Black-on-white,5,1030,1200,170,1,1,1
3256,Peach Springs,Red Mesa Black-on-white,10,880,1040,160,1,1,1
3256,Peach Springs,Toadlena Black-on-white,1,975,1125,150,1,1,1
3256,Peach Springs,"White Mountain type, Type Undifferentiated; Early",1,1000,1300,300,0,0,1
3256,Peach Springs,Wingate Black-on-red,2,1050,1225,175,1,1,1
3257,Penasco Blanco,Black Mesa Black-on-white,1,1000,1100,100,1,1,1
3257,Penasco Blanco,Black Mesa/Sosi Black-on-white,1,1000,1180,180,1,1,1
3257,Penasco Blanco,Blue Shale Corrugated,5,925,1150,225,0,0,0
3257,Penasco Blanco,"BMIII/PI White Ware, Type Undifferentiated",7,550,900,350,0,1,1
3257,Penasco Blanco,Chaco Black-on-white,11,1075,1150,75,1,1,1
3257,Penasco Blanco,Chaco-McElmo Black-on-white (carbon paint),12,1090,1175,85,1,1,1
3257,Penasco Blanco,Chuska Black-on-white,1,1040,1125,85,1,1,1
3257,Penasco Blanco,"Chuska Carbon Painted White Ware, Undifferentiated",27,800,1300,500,0,1,1
3257,Penasco Blanco,Chuska Indented Corrugated Gray,7,1040,1300,260,0,0,0
3257,Penasco Blanco,"Chuska Plain Gray Ware, Type Undifferentiated",1,700,925,225,0,0,0
3257,Penasco Blanco,"Chuska White Ware type, Undifferentiated",1,800,1300,500,0,1,1
3257,Penasco Blanco,Cibola Indented Corrugated Gray,3,1040,1400,360,0,0,0
3257,Penasco Blanco,"Cibola PII/PIII Gray Ware, Type Undifferentiated",2,950,1300,350,0,0,0
3257,Penasco Blanco,"Cibola PII/PIII White Ware, Type Undifferentiated",15,1000,1300,300,1,1,1
3257,Penasco Blanco,Cibola Plain Gray,1,550,1040,490,0,0,0
3257,Penasco Blanco,"Cibola White Ware, Undifferentiated",275,550,1325,775,0,1,1
3257,Penasco Blanco,"Corrugated Gray Ware, Undifferentiated",168,800,1400,600,0,0,0
3257,Penasco Blanco,Deadmans (La Plata) Black-on-red,2,880,1050,170,1,1,1
3257,Penasco Blanco,Escavada Black-on-white,8,1000,1100,100,1,1,1
3257,Penasco Blanco,Gallup Black-on-white,53,1040,1150,110,1,1,1
3257,Penasco Blanco,Gray Hills Banded,1,850,950,100,0,1,0
3257,Penasco Blanco,Holbrook Black-on-white,1,1050,1150,100,1,1,1
3257,Penasco Blanco,Kana-a Black-on-white,25,825,1000,175,1,1,1
3257,Penasco Blanco,Kiatuthlanna Black-on-white,8,850,925,75,1,1,1
3257,Penasco Blanco,Kiatuthlanna-Red Mesa Black-on-white,27,850,1040,190,1,1,1
3257,Penasco Blanco,Lino Black-on-gray (Cibola),1,600,850,250,1,1,1
3257,Penasco Blanco,Lino Gray (Cibola),2,550,950,400,1,0,0
3257,Penasco Blanco,Mancos Black-on-white,2,980,1180,200,1,1,1
3257,Penasco Blanco,McElmo Black-on-white,2,1060,1260,200,1,1,1
3257,Penasco Blanco,Medicine Black-on-red,3,1040,1170,130,1,1,1
3257,Penasco Blanco,Mogollon Indented Corrugated Brown Ware,2,1000,1400,400,0,0,0
3257,Penasco Blanco,"Narrow Neckbanded Gray Ware, Type Undifferentiated",215,900,1025,125,0,1,0
3257,Penasco Blanco,"Neck Indented Corrugated Gray Ware, Type Undifferentiated",23,950,1025,75,0,1,0
3257,Penasco Blanco,Newcomb Black-on-white,3,875,1000,125,1,1,1
3257,Penasco Blanco,Newcomb or Burnham Black-on-white,12,860,1000,140,1,1,1
3257,Penasco Blanco,"PII Gray Rim, Type Undifferentiated",6,900,1100,200,0,1,0
3257,Penasco Blanco,"PII/PIII Gray Rim, Type Undifferentiated",5,900,1300,400,0,0,0
3257,Penasco Blanco,"PII/PIII White Ware, Type Undifferentiated",173,900,1300,400,0,1,1
3257,Penasco Blanco,"Plain Gray Ware, Undifferentiated",590,500,1300,800,0,0,0
3257,Penasco Blanco,Puerco Black-on-white,14,1030,1200,170,1,1,1
3257,Penasco Blanco,Red Mesa Black-on-white,195,880,1040,160,1,1,1
3257,Penasco Blanco,"San Juan Red ware, Undifferentiated",27,700,1050,350,0,0,1
3257,Penasco Blanco,Sheep Springs Gray,1,800,850,50,0,1,0
3257,Penasco Blanco,Sosi Black-on-white,2,1070,1180,110,1,1,1
3257,Penasco Blanco,Toadlena Black-on-white,6,975,1125,150,1,1,1
3257,Penasco Blanco,"Tsegi Orange Ware, Undifferentiated",4,1000,1300,300,1,0,1
3257,Penasco Blanco,Tunicha Black-on-white,47,850,900,50,1,1,1
3257,Penasco Blanco,Tusayan Polychrome,1,1110,1320,210,1,1,1
3257,Penasco Blanco,"Tusayan White Ware, Undifferentiated",3,825,1300,475,0,1,1
3257,Penasco Blanco,"Wide Neckbanded Gray Ware, Type Undifferentiated",45,850,925,75,0,1,0
3257,Penasco Blanco,Wingate Black-on-red,1,1050,1225,175,1,1,1
3257,Penasco Blanco,Woodruff Smudged,15,500,1100,600,0,0,0
3258,Pierre's El Faro,Chaco Black-on-white,1,1075,1150,75,1,1,1
3258,Pierre's El Faro,Chuska Black-on-white,1,1040,1125,85,1,1,1
3258,Pierre's El Faro,"Chuska Corrugated Gray Ware, Undifferentiated",9,890,1300,410,0,0,0
3258,Pierre's El Faro,"Chuska White Ware type, Undifferentiated",4,800,1300,500,0,1,1
3258,Pierre's El Faro,"Cibola Black-on-white, Undifferentiated",105,550,1325,775,0,1,1
3258,Pierre's El Faro,Cibola Indented Corrugated Gray,5,1040,1400,360,0,0,0
3258,Pierre's El Faro,"Cibola PII/PIII Gray Ware, Type Undifferentiated",4,950,1300,350,0,0,0
3258,Pierre's El Faro,"Cibola PII/PIII White Ware, Type Undifferentiated",5,1000,1300,300,1,1,1
3258,Pierre's El Faro,Cibola Plain Gray,4,550,1040,490,0,0,0
3258,Pierre's El Faro,"Cibola White Ware, Undifferentiated",1,550,1325,775,0,1,1
3258,Pierre's El Faro,Escavada Black-on-white,5,1000,1100,100,1,1,1
3258,Pierre's El Faro,Hunter Corrugated,1,1100,1300,200,0,1,0
3258,Pierre's El Faro,Mancos Black-on-white,1,980,1180,200,1,1,1
3258,Pierre's El Faro,McElmo Black-on-white,1,1060,1260,200,1,1,1
3258,Pierre's El Faro,"Mesa Verde White Ware, Undifferentiated",4,575,1280,705,0,1,1
3258,Pierre's El Faro,"Red Ware type, Undifferentiated",1,700,1700,1000,0,0,0
3258,Pierre's El Faro,Toadlena Black-on-white,1,975,1125,150,1,1,1
3258,Pierre's El Faro,"White ware, Undifferentiated",2,550,1900,1350,0,0,1
3258,Pierre's El Faro,Woodruff Red Smudged,1,400,1100,700,0,0,0
3259,Pierre's House A,"Chuska Corrugated Gray Ware, Undifferentiated",20,890,1300,410,0,0,0
3259,Pierre's House A,"Chuska White Ware type, Undifferentiated",13,800,1300,500,0,1,1
3259,Pierre's House A,Cibola Narrow Neckbanded,1,900,1025,125,0,1,0
3259,Pierre's House A,"Cibola PII/PIII White Ware, Type Undifferentiated",3,1000,1300,300,1,1,1
3259,Pierre's House A,"Corrugated Gray Ware, Undifferentiated",65,800,1400,600,0,0,0
3259,Pierre's House A,Escavada Black-on-white,3,1000,1100,100,1,1,1
3259,Pierre's House A,Gallup Black-on-white,9,1040,1150,110,1,1,1
3259,Pierre's House A,Hunter Corrugated,1,1100,1300,200,0,1,0
3259,Pierre's House A,McElmo Black-on-white,2,1060,1260,200,1,1,1
3259,Pierre's House A,McElmo/Mesa Verde Black-on-white,3,1060,1280,220,1,1,1
3259,Pierre's House A,Mesa Verde Black-on-white,1,1180,1280,100,1,1,1
3259,Pierre's House A,"Mesa Verde PII/PIII White Ware, Type Undifferentiated",1,920,1280,360,0,1,1
3259,Pierre's House A,"Mesa Verde White Ware, Undifferentiated",1,575,1280,705,0,1,1
3259,Pierre's House A,Nava Black-on-white,1,1100,1275,175,1,1,1
3259,Pierre's House A,"PII/PIII Gray Rim, Type Undifferentiated",2,900,1300,400,0,0,0
3259,Pierre's House A,"PIII Gray Rim, Type Undifferentiated",4,1100,1300,200,0,1,0
3259,Pierre's House A,"Plain Gray Ware, Undifferentiated",4,500,1300,800,0,0,0
3259,Pierre's House A,Puerco Black-on-red,1,1000,1175,175,1,1,1
3259,Pierre's House A,"Type, Undifferentiated",1,200,1900,1700,0,0,0
3259,Pierre's House A,"White Mountain type, Type Undifferentiated; Early",2,1000,1300,300,0,0,1
3259,Pierre's House A,"White ware, Undifferentiated",1,550,1900,1350,0,0,1
3260,Pierre's House B/C,"Chuska Corrugated Gray Ware, Undifferentiated",6,890,1300,410,0,0,0
3260,Pierre's House B/C,"Chuska White Ware type, Undifferentiated",16,800,1300,500,0,1,1
3260,Pierre's House B/C,"Cibola PII/PIII White Ware, Type Undifferentiated",6,1000,1300,300,1,1,1
3260,Pierre's House B/C,"Corrugated Gray Ware, Undifferentiated",75,800,1400,600,0,0,0
3260,Pierre's House B/C,Escavada Black-on-white,4,1000,1100,100,1,1,1
3260,Pierre's House B/C,Gallup Black-on-white,11,1040,1150,110,1,1,1
3260,Pierre's House B/C,Mancos Black-on-white,1,980,1180,200,1,1,1
3260,Pierre's House B/C,McElmo/Mesa Verde Black-on-white,3,1060,1280,220,1,1,1
3260,Pierre's House B/C,"Mesa Verde White Ware, Undifferentiated",2,575,1280,705,0,1,1
3260,Pierre's House B/C,Newcomb Corrugated,1,875,950,75,0,1,0
3260,Pierre's House B/C,"PII/PIII Gray Rim, Type Undifferentiated",1,900,1300,400,0,0,0
3260,Pierre's House B/C,"PIII Gray Rim, Type Undifferentiated",3,1100,1300,200,0,1,0
3260,Pierre's House B/C,"Plain Gray Ware, Undifferentiated",2,500,1300,800,0,0,0
3260,Pierre's House B/C,Puerco Black-on-red,2,1000,1175,175,1,1,1
3260,Pierre's House B/C,Red Mesa Black-on-white,1,880,1040,160,1,1,1
3260,Pierre's House B/C,Wingate Black-on-red,3,1050,1225,175,1,1,1
3260,Pierre's House B/C,Woodruff Red Smudged,1,400,1100,700,0,0,0
3261,Point Pueblo,Bennett Gray,110,700,850,150,0,1,0
3261,Point Pueblo,Blue Shale Corrugated,2,925,1150,225,0,0,0
3261,Point Pueblo,"Brown Ware, Undifferentiated",4,500,1450,950,0,0,0
3261,Point Pueblo,Captain Tom Corrugated,8,890,1000,110,0,1,0
3261,Point Pueblo,Chapin Gray,24,575,980,405,0,0,0
3261,Point Pueblo,Chuska Indented Corrugated Gray,10,1040,1300,260,0,0,0
3261,Point Pueblo,"Chuska PI/PII Black-on-white, Type Undifferentiated",20,700,1100,400,0,1,1
3261,Point Pueblo,Cortez Black-on-white,21,880,1060,180,1,1,1
3261,Point Pueblo,Deadmans (La Plata) Black-on-red,3,880,1050,170,1,1,1
3261,Point Pueblo,Gallup Black-on-white,2,1040,1150,110,1,1,1
3261,Point Pueblo,Gray Hills Banded,70,850,950,100,0,1,0
3261,Point Pueblo,Hunter Corrugated,2,1100,1300,200,0,1,0
3261,Point Pueblo,"Indented Corrugated Gray Ware, Undifferentiated",110,950,1400,450,0,0,0
3261,Point Pueblo,Kana-a Black-on-white,6,825,1000,175,1,1,1
3261,Point Pueblo,Kiatuthlanna Black-on-white,2,850,925,75,1,1,1
3261,Point Pueblo,Lino Gray (Cibola),2,550,950,400,1,0,0
3261,Point Pueblo,Lino Gray (Tusayan),10,550,950,400,0,0,0
3261,Point Pueblo,Mancos Black-on-white,22,980,1180,200,1,1,1
3261,Point Pueblo,Mancos Corrugated,14,920,1180,260,0,0,0
3261,Point Pueblo,Mancos Gray,11,880,1060,180,0,1,0
3261,Point Pueblo,McElmo Black-on-white,10,1060,1260,200,1,1,1
3261,Point Pueblo,McElmo/Mesa Verde Black-on-white,2,1060,1280,220,1,1,1
3261,Point Pueblo,Mesa Verde Black-on-white,28,1180,1280,100,1,1,1
3261,Point Pueblo,Mesa Verde Corrugated,17,1100,1280,180,0,1,0
3261,Point Pueblo,"Mesa Verde PII/PIII White Ware, Type Undifferentiated",18,920,1280,360,0,1,1
3261,Point Pueblo,Moccasin Gray,3,800,980,180,0,1,0
3261,Point Pueblo,"Narrow Neckbanded Gray Ware, Type Undifferentiated",214,900,1025,125,0,1,0
3261,Point Pueblo,"Neck Indented Corrugated Gray Ware, Type Undifferentiated",54,950,1025,75,0,1,0
3261,Point Pueblo,Newcomb Black-on-white,2,875,1000,125,1,1,1
3261,Point Pueblo,Newcomb Corrugated,33,875,950,75,0,1,0
3261,Point Pueblo,Pena Black-on-white,1,800,900,100,1,1,1
3261,Point Pueblo,"PI/PII White Ware, Type Undifferentiated",114,700,1100,400,0,1,1
3261,Point Pueblo,"Plain Gray Ware, Undifferentiated",544,500,1300,800,0,0,0
3261,Point Pueblo,Puerco Black-on-red,1,1000,1175,175,1,1,1
3261,Point Pueblo,Red Mesa Black-on-white,42,880,1040,160,1,1,1
3261,Point Pueblo,"San Juan Red ware, Undifferentiated",28,700,1050,350,0,0,1
3261,Point Pueblo,Sheep Springs Gray,4,800,850,50,0,1,0
3261,Point Pueblo,Toadlena Black-on-white,2,975,1125,150,1,1,1
3261,Point Pueblo,Tocito Gray,18,825,875,50,0,1,0
3261,Point Pueblo,Tunicha Black-on-white,11,850,900,50,1,1,1
3261,Point Pueblo,"White Mountain type, Type Undifferentiated; Early",2,1000,1300,300,0,0,1
3261,Point Pueblo,"White ware, Undifferentiated",244,550,1900,1350,0,0,1
3261,Point Pueblo,"Wide Neckbanded Gray Ware, Type Undifferentiated",34,850,925,75,0,1,0
3261,Point Pueblo,Wingate Polychrome,2,1100,1225,125,1,1,1
3262,Pueblo Alto,Alma Series type,11,300,1000,700,0,0,0
3262,Pueblo Alto,Black Mesa Black-on-white,1,1000,1100,100,1,1,1
3262,Pueblo Alto,Black Mesa/Sosi Black-on-white,223,1000,1180,180,1,1,1
3262,Pueblo Alto,"BMIII/PI White Ware, Type Undifferentiated",41,550,900,350,0,1,1
3262,Pueblo Alto,Cameron Polychrome,6,1040,1170,130,1,1,1
3262,Pueblo Alto,Chaco Black-on-white,359,1075,1150,75,1,1,1
3262,Pueblo Alto,Chaco-McElmo Black-on-white (carbon paint),1287,1090,1175,85,1,1,1
3262,Pueblo Alto,Chuska Black-on-white,862,1040,1125,85,1,1,1
3262,Pueblo Alto,"Chuska Carbon Painted White Ware, Undifferentiated",451,800,1300,500,0,1,1
3262,Pueblo Alto,"Chuska White Ware type, Undifferentiated",1087,800,1300,500,0,1,1
3262,Pueblo Alto,"Cibola BMIII/PI White Ware, Type Undifferentiated",17,550,900,350,0,1,1
3262,Pueblo Alto,"Cibola White Ware, Undifferentiated",14018,550,1325,775,0,1,1
3262,Pueblo Alto,"Corrugated Gray Ware, Undifferentiated",55572,800,1400,600,0,0,0
3262,Pueblo Alto,Cortez Black-on-white,2,880,1060,180,1,1,1
3262,Pueblo Alto,Crumbled House Black-on-white,13,1150,1300,150,1,1,1
3262,Pueblo Alto,Deadmans (La Plata) Black-on-red,57,880,1050,170,1,1,1
3262,Pueblo Alto,Escavada Black-on-white,966,1000,1100,100,1,1,1
3262,Pueblo Alto,Gallup Black-on-white,10891,1040,1150,110,1,1,1
3262,Pueblo Alto,"Gray Ware, Undifferentiated",1,400,1400,1000,0,0,0
3262,Pueblo Alto,Holbrook Black-on-white,8,1050,1150,100,1,1,1
3262,Pueblo Alto,Kana-a Black-on-white,15,825,1000,175,1,1,1
3262,Pueblo Alto,Kiatuthlanna-Red Mesa Black-on-white,272,850,1040,190,1,1,1
3262,Pueblo Alto,Lino Black-on-gray (Cibola),3,600,850,250,1,1,1
3262,Pueblo Alto,Lino Gray (Cibola),2,550,950,400,1,0,0
3262,Pueblo Alto,Lino Gray Fugitive Red [Cibola Series],4,550,850,300,1,0,0
3262,Pueblo Alto,Mancos Black-on-white,63,980,1180,200,1,1,1
3262,Pueblo Alto,McElmo Black-on-white,606,1060,1260,200,1,1,1
3262,Pueblo Alto,Medicine/Tusayan Black-on-red,156,1040,1240,200,1,1,1
3262,Pueblo Alto,Mesa Verde Black-on-white,42,1180,1280,100,1,1,1
3262,Pueblo Alto,"Mesa Verde White Ware, Undifferentiated",429,575,1280,705,0,1,1
3262,Pueblo Alto,"Mudware, Undifferentiated",4,400,1400,1000,0,0,0
3262,Pueblo Alto,"Narrow Neckbanded Gray Ware, Type Undifferentiated",4410,900,1025,125,0,1,0
3262,Pueblo Alto,Nava Black-on-white,40,1100,1275,175,1,1,1
3262,Pueblo Alto,"Neck Indented Corrugated Gray Ware, Type Undifferentiated",412,950,1025,75,0,1,0
3262,Pueblo Alto,Newcomb or Burnham Black-on-white,362,860,1000,140,1,1,1
3262,Pueblo Alto,"PII Gray Rim, Type Undifferentiated",842,900,1100,200,0,1,0
3262,Pueblo Alto,"PII/PIII Gray Rim, Type Undifferentiated",426,900,1300,400,0,0,0
3262,Pueblo Alto,"PII/PIII White Ware, Type Undifferentiated",6126,900,1300,400,0,1,1
3262,Pueblo Alto,"PIII Gray Rim, Type Undifferentiated",155,1100,1300,200,0,1,0
3262,Pueblo Alto,"Plain Gray Ware, Undifferentiated",7242,500,1300,800,0,0,0
3262,Pueblo Alto,"Polychrome, Undifferentiated",21,700,1900,1200,0,1,1
3262,Pueblo Alto,Puerco Black-on-red,108,1000,1175,175,1,1,1
3262,Pueblo Alto,Puerco Black-on-white,2343,1030,1200,170,1,1,1
3262,Pueblo Alto,Red Mesa Black-on-white,4457,880,1040,160,1,1,1
3262,Pueblo Alto,"Red Ware type, Undifferentiated",1240,700,1700,1000,0,0,0
3262,Pueblo Alto,Reserve Black-on-white,1,1050,1200,150,1,1,1
3262,Pueblo Alto,"San Juan Red ware, Undifferentiated",142,700,1050,350,0,0,1
3262,Pueblo Alto,Socorro Black-on-white,1,1050,1300,250,1,1,1
3262,Pueblo Alto,St. Johns Black-on-red or Polychrome,7,1200,1300,100,1,1,1
3262,Pueblo Alto,Toadlena Black-on-white,189,975,1125,150,1,1,1
3262,Pueblo Alto,"Tsegi Orange Ware, Undifferentiated",73,1000,1300,300,1,0,1
3262,Pueblo Alto,Tunicha Black-on-white,12,850,900,50,1,1,1
3262,Pueblo Alto,"Tusayan White Ware, Undifferentiated",430,825,1300,475,0,1,1
3262,Pueblo Alto,"White Mountain type, Type Undifferentiated; Early",94,1000,1300,300,0,0,1
3262,Pueblo Alto,"White ware, Undifferentiated",11102,550,1900,1350,0,0,1
3262,Pueblo Alto,"Wide Neckbanded Gray Ware, Type Undifferentiated",390,850,925,75,0,1,0
3262,Pueblo Alto,Wingate Black-on-red,11,1050,1225,175,1,1,1
3262,Pueblo Alto,Woodruff Red Smudged,15,400,1100,700,0,0,0
3262,Pueblo Alto,Woodruff Smudged,2078,500,1100,600,0,0,0
3263,Pueblo Bonito,Black Mesa Black-on-white,1,1000,1100,100,1,1,1
3263,Pueblo Bonito,Black Mesa/Sosi Black-on-white,17,1000,1180,180,1,1,1
3263,Pueblo Bonito,"BMIII/PI White Ware, Type Undifferentiated",20,550,900,350,0,1,1
3263,Pueblo Bonito,Chaco Black-on-white,26,1075,1150,75,1,1,1
3263,Pueblo Bonito,Chaco-McElmo Black-on-white (carbon paint),21,1090,1175,85,1,1,1
3263,Pueblo Bonito,Chuska Black-on-white,2,1040,1125,85,1,1,1
3263,Pueblo Bonito,"Chuska Carbon Painted White Ware, Undifferentiated",46,800,1300,500,0,1,1
3263,Pueblo Bonito,"Cibola White Ware, Undifferentiated",464,550,1325,775,0,1,1
3263,Pueblo Bonito,"Corrugated Gray Ware, Undifferentiated",909,800,1400,600,0,0,0
3263,Pueblo Bonito,Escavada Black-on-white,5,1000,1100,100,1,1,1
3263,Pueblo Bonito,Gallup Black-on-white,203,1040,1150,110,1,1,1
3263,Pueblo Bonito,Kana-a Black-on-white,11,825,1000,175,1,1,1
3263,Pueblo Bonito,Kiatuthlanna-Red Mesa Black-on-white,18,850,1040,190,1,1,1
3263,Pueblo Bonito,Lino Gray (Cibola),5,550,950,400,1,0,0
3263,Pueblo Bonito,Lino Gray Fugitive Red [Cibola Series],15,550,850,300,1,0,0
3263,Pueblo Bonito,Mancos Black-on-white,2,980,1180,200,1,1,1
3263,Pueblo Bonito,McElmo Black-on-white,14,1060,1260,200,1,1,1
3263,Pueblo Bonito,"Mesa Verde White Ware, Undifferentiated",6,575,1280,705,0,1,1
3263,Pueblo Bonito,"Narrow Neckbanded Gray Ware, Type Undifferentiated",207,900,1025,125,0,1,0
3263,Pueblo Bonito,Newcomb or Burnham Black-on-white,1,860,1000,140,1,1,1
3263,Pueblo Bonito,"PII Gray Rim, Type Undifferentiated",14,900,1100,200,0,1,0
3263,Pueblo Bonito,"PII/PIII Gray Rim, Type Undifferentiated",10,900,1300,400,0,0,0
3263,Pueblo Bonito,"PII/PIII White Ware, Type Undifferentiated",590,900,1300,400,0,1,1
3263,Pueblo Bonito,"PIII Gray Rim, Type Undifferentiated",1,1100,1300,200,0,1,0
3263,Pueblo Bonito,"Plain Gray Ware, Undifferentiated",587,500,1300,800,0,0,0
3263,Pueblo Bonito,Puerco Black-on-red,2,1000,1175,175,1,1,1
3263,Pueblo Bonito,Puerco Black-on-white,38,1030,1200,170,1,1,1
3263,Pueblo Bonito,Red Mesa Black-on-white,110,880,1040,160,1,1,1
3263,Pueblo Bonito,"Red Ware type, Undifferentiated",2,700,1700,1000,0,0,0
3263,Pueblo Bonito,"San Juan Red ware, Undifferentiated",18,700,1050,350,0,0,1
3263,Pueblo Bonito,Sanostee Black-on-red,15,825,875,50,1,1,1
3263,Pueblo Bonito,Toadlena Black-on-white,17,975,1125,150,1,1,1
3263,Pueblo Bonito,"Tsegi Orange Ware, Undifferentiated",11,1000,1300,300,1,0,1
3263,Pueblo Bonito,Tunicha Black-on-white,14,850,900,50,1,1,1
3263,Pueblo Bonito,"Tusayan White Ware, Undifferentiated",16,825,1300,475,0,1,1
3263,Pueblo Bonito,"White Mountain type, Type Undifferentiated; Early",5,1000,1300,300,0,0,1
3263,Pueblo Bonito,"Wide Neckbanded Gray Ware, Type Undifferentiated",24,850,925,75,0,1,0
3263,Pueblo Bonito,Wingate Black-on-red,1,1050,1225,175,1,1,1
3263,Pueblo Bonito,Woodruff Smudged,76,500,1100,600,0,0,0
3264,Pueblo Cerrito,Cebolleta Black-on-white,14,1000,1200,200,1,1,1
3264,Pueblo Cerrito,Cibola Indented Corrugated Gray,94,1040,1400,360,0,0,0
3264,Pueblo Cerrito,Cibola Plain Gray,2,550,1040,490,0,0,0
3264,Pueblo Cerrito,"Cibola White Ware, Undifferentiated",39,550,1325,775,0,1,1
3264,Pueblo Cerrito,Escavada Black-on-white,4,1000,1100,100,1,1,1
3264,Pueblo Cerrito,Los Lunas Smudged,5,1100,1350,250,0,0,0
3264,Pueblo Cerrito,Mogollon Plain Brown Ware,1,300,1400,1100,0,0,0
3264,Pueblo Cerrito,Puerco Black-on-red,1,1000,1175,175,1,1,1
3264,Pueblo Cerrito,Socorro Black-on-white,32,1050,1300,250,1,1,1
3264,Pueblo Cerrito,St. Johns Black-on-red,3,1200,1300,100,1,1,1
3264,Pueblo Cerrito,St. Johns Polychrome,3,1200,1300,100,1,1,1
3264,Pueblo Cerrito,Tularosa Black-on-white,14,1180,1300,120,1,1,1
3264,Pueblo Cerrito,"White Mountain type, Type Undifferentiated; Early",8,1000,1300,300,0,0,1
3264,Pueblo Cerrito,Wingate Black-on-red,4,1050,1225,175,1,1,1
3264,Pueblo Cerrito,Wingate Polychrome,1,1100,1225,125,1,1,1
3265,Pueblo de los Golondrinas,Abajo Red-on-orange,3,760,880,120,1,1,1
3265,Pueblo de los Golondrinas,Bluff Black-on-red,269,800,925,125,1,1,1
3265,Pueblo de los Golondrinas,Chapin Black-on-white,28,575,880,305,0,1,1
3265,Pueblo de los Golondrinas,Chapin Gray,890,575,980,405,0,0,0
3265,Pueblo de los Golondrinas,Cortez Black-on-white,3,880,1060,180,1,1,1
3265,Pueblo de los Golondrinas,Deadmans (La Plata) Black-on-red,44,880,1050,170,1,1,1
3265,Pueblo de los Golondrinas,Drolet Black-on-white,4,900,1000,100,1,1,1
3265,Pueblo de los Golondrinas,Kana-a Black-on-white,1,825,1000,175,1,1,1
3265,Pueblo de los Golondrinas,Mancos Corrugated,1,920,1180,260,0,0,0
3265,Pueblo de los Golondrinas,Mancos Gray,272,880,1060,180,0,1,0
3265,Pueblo de los Golondrinas,McElmo Black-on-white,1,1060,1260,200,1,1,1
3265,Pueblo de los Golondrinas,"Mesa Verde BMIII/PI White Ware, Type Undifferentiated",11,575,920,345,0,1,1
3265,Pueblo de los Golondrinas,"Mesa Verde Corrugated Gray Ware, Undifferentiated",22,920,1280,360,0,0,0
3265,Pueblo de los Golondrinas,"Mesa Verde PII/PIII White Ware, Type Undifferentiated",1,920,1280,360,0,1,1
3265,Pueblo de los Golondrinas,Mesa Verde Plain Gray,20261,575,1020,445,0,0,0
3265,Pueblo de los Golondrinas,Moccasin Gray,2768,800,980,180,0,1,0
3265,Pueblo de los Golondrinas,Naschitti Black-on-white,1,900,1000,100,1,1,1
3265,Pueblo de los Golondrinas,Piedra Black-on-white,101,800,920,120,1,1,1
3265,Pueblo de los Golondrinas,"Plain Brown Smudged, Undifferentiated",1,400,1450,1050,0,0,0
3265,Pueblo de los Golondrinas,Red Mesa Black-on-white,3,880,1040,160,1,1,1
3265,Pueblo de los Golondrinas,"San Juan Red ware, Undifferentiated",1309,700,1050,350,0,0,1
3265,Pueblo de los Golondrinas,Sheep Springs Gray,2,800,850,50,0,1,0
3266,Pueblo del Arroyo,Chaco Black-on-white,1,1075,1150,75,1,1,1
3266,Pueblo del Arroyo,Chaco-McElmo Black-on-white (carbon paint),14,1090,1175,85,1,1,1
3266,Pueblo del Arroyo,Chuska Black-on-white,5,1040,1125,85,1,1,1
3266,Pueblo del Arroyo,"Chuska Carbon Painted White Ware, Undifferentiated",5,800,1300,500,0,1,1
3266,Pueblo del Arroyo,"Cibola White Ware, Undifferentiated",47,550,1325,775,0,1,1
3266,Pueblo del Arroyo,"Corrugated Gray Ware, Undifferentiated",185,800,1400,600,0,0,0
3266,Pueblo del Arroyo,Escavada Black-on-white,7,1000,1100,100,1,1,1
3266,Pueblo del Arroyo,Gallup Black-on-white,32,1040,1150,110,1,1,1
3266,Pueblo del Arroyo,Holbrook Black-on-white,1,1050,1150,100,1,1,1
3266,Pueblo del Arroyo,Mancos Black-on-white,1,980,1180,200,1,1,1
3266,Pueblo del Arroyo,McElmo Black-on-white,3,1060,1260,200,1,1,1
3266,Pueblo del Arroyo,"Mesa Verde White Ware, Undifferentiated",7,575,1280,705,0,1,1
3266,Pueblo del Arroyo,"Narrow Neckbanded Gray Ware, Type Undifferentiated",5,900,1025,125,0,1,0
3266,Pueblo del Arroyo,"PII/PIII Gray Rim, Type Undifferentiated",3,900,1300,400,0,0,0
3266,Pueblo del Arroyo,"PII/PIII White Ware, Type Undifferentiated",34,900,1300,400,0,1,1
3266,Pueblo del Arroyo,"PIII Gray Rim, Type Undifferentiated",2,1100,1300,200,0,1,0
3266,Pueblo del Arroyo,"Plain Gray Ware, Undifferentiated",1,500,1300,800,0,0,0
3266,Pueblo del Arroyo,Puerco Black-on-red,5,1000,1175,175,1,1,1
3266,Pueblo del Arroyo,Puerco Black-on-white,8,1030,1200,170,1,1,1
3266,Pueblo del Arroyo,Toadlena Black-on-white,5,975,1125,150,1,1,1
3266,Pueblo del Arroyo,"Tsegi Orange Ware, Undifferentiated",1,1000,1300,300,1,0,1
3266,Pueblo del Arroyo,"White Mountain type, Type Undifferentiated; Early",3,1000,1300,300,0,0,1
3266,Pueblo del Arroyo,Wingate Black-on-red,1,1050,1225,175,1,1,1
3266,Pueblo del Arroyo,Woodruff Smudged,12,500,1100,600,0,0,0
3267,Ram Mesa,Chaco-McElmo Black-on-white (carbon paint),2,1090,1175,85,1,1,1
3267,Ram Mesa,"Cibola Gray Ware, Undifferentiated",4,550,1400,850,0,0,0
3267,Ram Mesa,Cibola Indented Corrugated Gray,119,1040,1400,360,0,0,0
3267,Ram Mesa,Cibola Neckbanded Gray,5,850,1025,175,0,1,0
3267,Ram Mesa,Cibola Plain Gray,35,550,1040,490,0,0,0
3267,Ram Mesa,"Cibola White Ware, Undifferentiated",29,550,1325,775,0,1,1
3267,Ram Mesa,Escavada Black-on-white,19,1000,1100,100,1,1,1
3267,Ram Mesa,Gallup Black-on-white,26,1040,1150,110,1,1,1
3267,Ram Mesa,Red Mesa Black-on-white,21,880,1040,160,1,1,1
3267,Ram Mesa,"White Mountain type, Type Undifferentiated; Early",1,1000,1300,300,0,0,1
3267,Ram Mesa,Wingate Black-on-red,1,1050,1225,175,1,1,1
3269,Recapture GK,Abajo Red-on-orange,2,760,880,120,1,1,1
3269,Recapture GK,Chapin Gray,1,575,980,405,0,0,0
3269,Recapture GK,Cortez Black-on-white,2,880,1060,180,1,1,1
3269,Recapture GK,Deadmans (La Plata) Black-on-red,7,880,1050,170,1,1,1
3269,Recapture GK,Mancos Black-on-white,5,980,1180,200,1,1,1
3269,Recapture GK,Mancos Corrugated,1,920,1180,260,0,0,0
3269,Recapture GK,Mancos Gray,29,880,1060,180,0,1,0
3269,Recapture GK,"Mesa Verde Corrugated Gray Ware, Undifferentiated",14,920,1280,360,0,0,0
3269,Recapture GK,Mesa Verde Neckbanded Gray,2,800,1060,260,0,0,0
3269,Recapture GK,"Mesa Verde PII White Ware, Type Undifferentiated",3,920,1100,180,1,1,1
3269,Recapture GK,"Mesa Verde PII/PIII White Ware, Type Undifferentiated",9,920,1280,360,0,1,1
3269,Recapture GK,Mesa Verde Plain Gray,93,575,1020,445,0,0,0
3269,Recapture GK,"San Juan Red ware, Undifferentiated",16,700,1050,350,0,0,1
3269,Recapture GK,White Mesa Black-on-white,5,850,1000,150,1,1,1
3269,Recapture GK,"White ware, Undifferentiated",4,550,1900,1350,0,0,1
3270,Red Knobs,Abajo Red-on-orange,48,760,880,120,1,1,1
3270,Red Knobs,Bluff Black-on-red,79,800,925,125,1,1,1
3270,Red Knobs,Chapin Black-on-white,1,575,880,305,0,1,1
3270,Red Knobs,Chapin Gray,30,575,980,405,0,0,0
3270,Red Knobs,Deadmans (La Plata) Black-on-red,15,880,1050,170,1,1,1
3270,Red Knobs,Dogoszhi Black-on-white,1,1040,1210,170,1,1,1
3270,Red Knobs,Dolores Corrugated,29,1100,1200,100,0,1,0
3270,Red Knobs,Mancos Black-on-white,205,980,1180,200,1,1,1
3270,Red Knobs,Mancos Corrugated,10,920,1180,260,0,0,0
3270,Red Knobs,Mancos Gray,196,880,1060,180,0,1,0
3270,Red Knobs,McElmo Black-on-white,115,1060,1260,200,1,1,1
3270,Red Knobs,Medicine Black-on-red,1,1040,1170,130,1,1,1
3270,Red Knobs,Mesa Verde Black-on-white,12,1180,1280,100,1,1,1
3270,Red Knobs,Mesa Verde Corrugated,7,1100,1280,180,0,1,0
3270,Red Knobs,"Mesa Verde Corrugated Gray Ware, Undifferentiated",1100,920,1280,360,0,0,0
3270,Red Knobs,"Mesa Verde Gray ware, Undifferentiated",2,575,1280,705,0,0,0
3270,Red Knobs,"Mesa Verde PII White Ware, Type Undifferentiated",356,920,1100,180,1,1,1
3270,Red Knobs,"Mesa Verde PIII White Ware, Type Undifferentiated",631,1100,1280,180,1,1,1
3270,Red Knobs,Mesa Verde Plain Gray,1378,575,1020,445,0,0,0
3270,Red Knobs,Moccasin Gray,51,800,980,180,0,1,0
3270,Red Knobs,"Red Ware type, Undifferentiated",5,700,1700,1000,0,0,0
3270,Red Knobs,"San Juan Red ware, Undifferentiated",92,700,1050,350,0,0,1
3270,Red Knobs,Sosi Black-on-white,1,1070,1180,110,1,1,1
3270,Red Knobs,"Tsegi Orange Ware, Undifferentiated",5,1000,1300,300,1,0,1
3270,Red Knobs,"Tsegi Polychrome, Undifferentiated",3,1040,1320,280,1,1,1
3270,Red Knobs,Tusayan Black-on-red,3,1045,1240,195,1,1,1
3270,Red Knobs,"Type, Undifferentiated",1,200,1900,1700,0,0,0
3270,Red Knobs,White Mesa Black-on-white,27,850,1000,150,1,1,1
3270,Red Knobs,"White ware, Undifferentiated",10,550,1900,1350,0,0,1
3272,Red Pottery Mound,Bluff Black-on-red,1,800,925,125,1,1,1
3272,Red Pottery Mound,Chapin Gray,110,575,980,405,0,0,0
3272,Red Pottery Mound,Cortez Black-on-white,2,880,1060,180,1,1,1
3272,Red Pottery Mound,Deadmans (La Plata) Black-on-red,1,880,1050,170,1,1,1
3272,Red Pottery Mound,Mancos Gray,166,880,1060,180,0,1,0
3272,Red Pottery Mound,"Mesa Verde BMIII/PI White Ware, Type Undifferentiated",3,575,920,345,0,1,1
3272,Red Pottery Mound,"Mesa Verde Corrugated Gray Ware, Undifferentiated",8,920,1280,360,0,0,0
3272,Red Pottery Mound,Mesa Verde Plain Gray,3230,575,1020,445,0,0,0
3272,Red Pottery Mound,Moccasin Gray,324,800,980,180,0,1,0
3272,Red Pottery Mound,Piedra Black-on-white,8,800,920,120,1,1,1
3272,Red Pottery Mound,"San Juan Red ware, Undifferentiated",73,700,1050,350,0,0,1
3273,Red Willow,Black Mesa Black-on-white,1,1000,1100,100,1,1,1
3273,Red Willow,Chaco Black-on-white,4,1075,1150,75,1,1,1
3273,Red Willow,Chaco-McElmo Black-on-white (carbon paint),2,1090,1175,85,1,1,1
3273,Red Willow,Chuska Indented Corrugated Gray,8,1040,1300,260,0,0,0
3273,Red Willow,"Chuska Plain Gray Ware, Type Undifferentiated",1,700,925,225,0,0,0
3273,Red Willow,Cibola Indented Corrugated Gray,7,1040,1400,360,0,0,0
3273,Red Willow,Cibola Plain Gray,1,550,1040,490,0,0,0
3273,Red Willow,"Cibola White Ware, Undifferentiated",3,550,1325,775,0,1,1
3273,Red Willow,Escavada Black-on-white,4,1000,1100,100,1,1,1
3273,Red Willow,Flagstaff Black-on-white,3,1150,1220,70,1,1,1
3273,Red Willow,Gallup Black-on-white,10,1040,1150,110,1,1,1
3273,Red Willow,Gray Hills Banded,1,850,950,100,0,1,0
3273,Red Willow,McElmo/Mesa Verde Black-on-white,1,1060,1280,220,1,1,1
3273,Red Willow,Red Mesa Black-on-white,8,880,1040,160,1,1,1
3273,Red Willow,"San Juan Red ware, Undifferentiated",2,700,1050,350,0,0,1
3273,Red Willow,Sosi Black-on-white,5,1070,1180,110,1,1,1
3273,Red Willow,St. Johns Black-on-red,3,1200,1300,100,1,1,1
3273,Red Willow,St. Johns Polychrome,1,1200,1300,100,1,1,1
3273,Red Willow,Tularosa Black-on-white,2,1180,1300,120,1,1,1
3275,Reservoir--Northern San Juan,"Brown Ware, Undifferentiated",1,500,1450,950,0,0,0
3275,Reservoir--Northern San Juan,Chaco-McElmo Black-on-white (carbon paint),2,1090,1175,85,1,1,1
3275,Reservoir--Northern San Juan,Chapin Gray,3,575,980,405,0,0,0
3275,Reservoir--Northern San Juan,Chuska Black-on-white,1,1040,1125,85,1,1,1
3275,Reservoir--Northern San Juan,Cortez Black-on-white,9,880,1060,180,1,1,1
3275,Reservoir--Northern San Juan,Deadmans (La Plata) Black-on-red,6,880,1050,170,1,1,1
3275,Reservoir--Northern San Juan,Dogoszhi Black-on-white,1,1040,1210,170,1,1,1
3275,Reservoir--Northern San Juan,Dolores Corrugated,11,1100,1200,100,0,1,0
3275,Reservoir--Northern San Juan,Gallup Black-on-white,2,1040,1150,110,1,1,1
3275,Reservoir--Northern San Juan,Mancos Black-on-white,81,980,1180,200,1,1,1
3275,Reservoir--Northern San Juan,Mancos Corrugated,14,920,1180,260,0,0,0
3275,Reservoir--Northern San Juan,Mancos Gray,12,880,1060,180,0,1,0
3275,Reservoir--Northern San Juan,McElmo Black-on-white,5,1060,1260,200,1,1,1
3275,Reservoir--Northern San Juan,"Mesa Verde BMIII/PI White Ware, Type Undifferentiated",14,575,920,345,0,1,1
3275,Reservoir--Northern San Juan,Mesa Verde Corrugated,5,1100,1280,180,0,1,0
3275,Reservoir--Northern San Juan,"Mesa Verde Corrugated Gray Ware, Undifferentiated",1101,920,1280,360,0,0,0
3275,Reservoir--Northern San Juan,"Mesa Verde PII White Ware, Type Undifferentiated",22,920,1100,180,1,1,1
3275,Reservoir--Northern San Juan,"Mesa Verde PII/PIII White Ware, Type Undifferentiated",171,920,1280,360,0,1,1
3275,Reservoir--Northern San Juan,"Mesa Verde PIII White Ware, Type Undifferentiated",7,1100,1280,180,1,1,1
3275,Reservoir--Northern San Juan,Mesa Verde Plain Gray,229,575,1020,445,0,0,0
3275,Reservoir--Northern San Juan,Moccasin Gray,7,800,980,180,0,1,0
3275,Reservoir--Northern San Juan,"Plain Brown Smudged, Undifferentiated",1,400,1450,1050,0,0,0
3275,Reservoir--Northern San Juan,Red Mesa Black-on-white,1,880,1040,160,1,1,1
3275,Reservoir--Northern San Juan,"San Juan Red ware, Undifferentiated",8,700,1050,350,0,0,1
3275,Reservoir--Northern San Juan,"Type, Undifferentiated",1,200,1900,1700,0,0,0
3276,Rincon Great Kiva,Abajo Red-on-orange,3,760,880,120,1,1,1
3276,Rincon Great Kiva,Bluff Black-on-red,18,800,925,125,1,1,1
3276,Rincon Great Kiva,Chapin Gray,12,575,980,405,0,0,0
3276,Rincon Great Kiva,Deadmans (La Plata) Black-on-red,8,880,1050,170,1,1,1
3276,Rincon Great Kiva,Dolores Corrugated,1,1100,1200,100,0,1,0
3276,Rincon Great Kiva,"Little Colorado Gray Ware, Undifferentiated",100,850,1300,450,0,0,0
3276,Rincon Great Kiva,Mancos Black-on-white,14,980,1180,200,1,1,1
3276,Rincon Great Kiva,Mancos Corrugated,2,920,1180,260,0,0,0
3276,Rincon Great Kiva,Mancos Gray,2,880,1060,180,0,1,0
3276,Rincon Great Kiva,McElmo Black-on-white,7,1060,1260,200,1,1,1
3276,Rincon Great Kiva,Mesa Verde Black-on-white,1,1180,1280,100,1,1,1
3276,Rincon Great Kiva,Mesa Verde Plain Gray,1000,575,1020,445,0,0,0
3276,Rincon Great Kiva,"Mesa Verde White Ware, Undifferentiated",7,575,1280,705,0,1,1
3276,Rincon Great Kiva,Moccasin Gray,2,800,980,180,0,1,0
3276,Rincon Great Kiva,"San Juan Red ware, Undifferentiated",103,700,1050,350,0,0,1
3276,Rincon Great Kiva,"White Mountain type, Type Undifferentiated; Early",1,1000,1300,300,0,0,1
3280,Sambrito Village,Arboles Black-on-white,1,950,1050,100,1,1,1
3280,Sambrito Village,Dinetah Gray,4,1500,1750,250,0,0,0
3280,Sambrito Village,Jeddito Black-on-yellow,1,1300,1450,150,1,1,1
3280,Sambrito Village,Jemez Black-on-white,9,1300,1750,450,0,1,1
3280,Sambrito Village,Piedra Black-on-white,7,800,920,120,1,1,1
3280,Sambrito Village,Puerco Black-on-white,1,1030,1200,170,1,1,1
3280,Sambrito Village,Red Mesa Black-on-white,3,880,1040,160,1,1,1
3280,Sambrito Village,"Rio Grande Glaze, Undifferentiated",24,1313,1700,387,0,0,1
3280,Sambrito Village,Rosa Black-on-white,4,700,875,175,1,1,1
3280,Sambrito Village,Rosa Gray,40,700,1000,300,0,0,0
3280,Sambrito Village,Rosa Neckbanded,16,775,900,125,0,1,0
3280,Sambrito Village,San Bernardo Polychrome,13,1625,1740,115,1,1,1
3280,Sambrito Village,"White ware, Undifferentiated",3,550,1900,1350,0,0,1
3281,San Mateo,Chaco-McElmo Black-on-white (carbon paint),5,1090,1175,85,1,1,1
3281,San Mateo,"Cibola Black-on-white, Undifferentiated",21,550,1325,775,0,1,1
3281,San Mateo,Cibola Clapboard Corrugated Gray,3,900,1100,200,0,1,0
3281,San Mateo,"Cibola Gray Ware, Undifferentiated",1,550,1400,850,0,0,0
3281,San Mateo,Cibola Indented Corrugated Gray,122,1040,1400,360,0,0,0
3281,San Mateo,Cibola Narrow Neckbanded,4,900,1025,125,0,1,0
3281,San Mateo,Cibola Neckbanded Gray,10,850,1025,175,0,1,0
3281,San Mateo,"Cibola PII/PIII White Ware, Type Undifferentiated",47,1000,1300,300,1,1,1
3281,San Mateo,Cibola Plain Gray,25,550,1040,490,0,0,0
3281,San Mateo,Cortez Black-on-white,1,880,1060,180,1,1,1
3281,San Mateo,Escavada Black-on-white,2,1000,1100,100,1,1,1
3281,San Mateo,Escavada-Puerco Black-on-white,12,1000,1100,100,1,1,1
3281,San Mateo,Gallup Black-on-white,23,1040,1150,110,1,1,1
3281,San Mateo,Kana'a Neckbanded,11,865,1060,195,0,1,0
3281,San Mateo,Kiatuthlanna Black-on-white,1,850,925,75,1,1,1
3281,San Mateo,McElmo Black-on-white,1,1060,1260,200,1,1,1
3281,San Mateo,Puerco Black-on-red,1,1000,1175,175,1,1,1
3281,San Mateo,Puerco Black-on-white,1,1030,1200,170,1,1,1
3281,San Mateo,Red Mesa Black-on-white,34,880,1040,160,1,1,1
3281,San Mateo,Reserve Black-on-white,3,1050,1200,150,1,1,1
3281,San Mateo,"San Juan Red ware, Undifferentiated",1,700,1050,350,0,0,1
3281,San Mateo,St. Johns Polychrome,1,1200,1300,100,1,1,1
3281,San Mateo,Tularosa Black-on-white,1,1180,1300,120,1,1,1
3281,San Mateo,"Type, Undifferentiated",3,200,1900,1700,0,0,0
3281,San Mateo,"White Mountain type, Type Undifferentiated; Early",3,1000,1300,300,0,0,1
3281,San Mateo,Woodruff Smudged,1,500,1100,600,0,0,0
3283,Sanders GH,Abajo Red-on-orange,2,760,880,120,1,1,1
3283,Sanders GH,Adamana Brown,2,300,550,250,0,0,0
3283,Sanders GH,Bennett Gray,2,700,850,150,0,1,0
3283,Sanders GH,Black Mesa Black-on-white,86,1000,1100,100,1,1,1
3283,Sanders GH,Bluff Black-on-red,10,800,925,125,1,1,1
3283,Sanders GH,Chaco Black-on-white,28,1075,1150,75,1,1,1
3283,Sanders GH,Chuska Indented Corrugated Gray,2,1040,1300,260,0,0,0
3283,Sanders GH,"Chuska Orange Ware, Undifferentiated",2,825,875,50,1,1,1
3283,Sanders GH,"Chuska Plain Gray Ware, Type Undifferentiated",6,700,925,225,0,0,0
3283,Sanders GH,"Cibola Black-on-white, Undifferentiated",4726,550,1325,775,0,1,1
3283,Sanders GH,Cibola Clapboard Corrugated Gray,2090,900,1100,200,0,1,0
3283,Sanders GH,Cibola Indented Corrugated Gray,10448,1040,1400,360,0,0,0
3283,Sanders GH,Cibola Narrow Neckbanded,2,900,1025,125,0,1,0
3283,Sanders GH,Cibola Neckbanded Gray,680,850,1025,175,0,1,0
3283,Sanders GH,"Cibola PII Gray Ware, Type Undifferentiated",4,950,1100,150,0,1,0
3283,Sanders GH,"Cibola PII/PIII Gray Ware, Type Undifferentiated",2,950,1300,350,0,0,0
3283,Sanders GH,"Cibola PII/PIII White Ware, Type Undifferentiated",42,1000,1300,300,1,1,1
3283,Sanders GH,"Cibola PIII Gray Ware, Type Undifferentiated",2,1100,1300,200,0,1,0
3283,Sanders GH,Cibola Plain Corrugated Gray,48,900,1100,200,0,1,0
3283,Sanders GH,Cibola Plain Gray,1878,550,1040,490,0,0,0
3283,Sanders GH,"Cibola White Ware, Undifferentiated",52,550,1325,775,0,1,1
3283,Sanders GH,"Clapboard Corrugated Gray Ware, Undifferentiated",2,900,1100,200,0,1,0
3283,Sanders GH,Dolores Corrugated,2,1100,1200,100,0,1,0
3283,Sanders GH,Escavada Black-on-white,620,1000,1100,100,1,1,1
3283,Sanders GH,Escavada-Puerco Black-on-white,108,1000,1100,100,1,1,1
3283,Sanders GH,Gallup Black-on-white,498,1040,1150,110,1,1,1
3283,Sanders GH,Gray Hills Banded,2,850,950,100,0,1,0
3283,Sanders GH,"Gray Ware, Undifferentiated",274,400,1400,1000,0,0,0
3283,Sanders GH,Holbrook B Black-on-white,10,1050,1150,100,1,1,1
3283,Sanders GH,"Indented Corrugated Gray Ware, Undifferentiated",726,950,1400,450,0,0,0
3283,Sanders GH,Kana-a Black-on-white,8,825,1000,175,1,1,1
3283,Sanders GH,Kayenta Black-on-white,4,1250,1300,50,1,1,1
3283,Sanders GH,Kiatuthlanna Black-on-white,256,850,925,75,1,1,1
3283,Sanders GH,La Plata-White Mound Black-on-white,2,550,850,300,1,1,1
3283,Sanders GH,Lino Gray Fugitive Red [Cibola Series],4,550,850,300,1,0,0
3283,Sanders GH,"Little Colorado White Ware, Undifferentiated",52,825,1250,425,0,1,1
3283,Sanders GH,"Mesa Verde Gray ware, Undifferentiated",4,575,1280,705,0,0,0
3283,Sanders GH,Mogollon Indented Corrugated Brown Ware,2,1000,1400,400,0,0,0
3283,Sanders GH,Mogollon Plain Brown Ware,4,300,1400,1100,0,0,0
3283,Sanders GH,"Mudware, Undifferentiated",2,400,1400,1000,0,0,0
3283,Sanders GH,Mummy Lake Gray,2,1150,1280,130,0,1,0
3283,Sanders GH,"Obliterated Corrugated Gray Ware, Undifferentiated",40,1100,1400,300,0,0,0
3283,Sanders GH,"Orange Ware, Undifferentiated",2,1000,1350,350,0,0,0
3283,Sanders GH,Padre Black-on-white,4,1100,1250,150,1,1,1
3283,Sanders GH,"Plain Gray Ware, Undifferentiated",1358,500,1300,800,0,0,0
3283,Sanders GH,Puerco Black-on-red,10,1000,1175,175,1,1,1
3283,Sanders GH,Puerco Black-on-white,110,1030,1200,170,1,1,1
3283,Sanders GH,Puerco or Red Mesa Black-on-white,4,880,1200,320,0,0,1
3283,Sanders GH,"Puerco Valley Corrugated Gray Ware, Undifferentiated",2340,800,1300,500,0,0,0
3283,Sanders GH,"Puerco Valley Gray Ware, Undifferentiated",1298,400,1300,900,0,0,0
3283,Sanders GH,Red Mesa Black-on-white,790,880,1040,160,1,1,1
3283,Sanders GH,"Red Ware type, Undifferentiated",8,700,1700,1000,0,0,0
3283,Sanders GH,Reserve Black-on-white,448,1050,1200,150,1,1,1
3283,Sanders GH,"San Juan Red ware, Undifferentiated",2,700,1050,350,0,0,1
3283,Sanders GH,Shato Black-on-white,2,1025,1150,125,1,1,1
3283,Sanders GH,Showlow Black-on-red,60,1030,1200,170,1,1,1
3283,Sanders GH,Showlow Red,408,1000,1100,100,0,1,0
3283,Sanders GH,Showlow Red Corrugated,162,1030,1280,250,0,0,0
3283,Sanders GH,Snowflake Black-on-white,4,1100,1275,175,1,1,1
3283,Sanders GH,Sosi Black-on-white,34,1070,1180,110,1,1,1
3283,Sanders GH,St. Johns Polychrome,2,1200,1300,100,1,1,1
3283,Sanders GH,Tularosa Black-on-white,10,1180,1300,120,1,1,1
3283,Sanders GH,Tunicha Black-on-white,2,850,900,50,1,1,1
3283,Sanders GH,Tusayan Plain Gray,3908,600,1300,700,0,0,0
3283,Sanders GH,"Tusayan White Ware, Undifferentiated",154,825,1300,475,0,1,1
3283,Sanders GH,"Type, Undifferentiated",8914,200,1900,1700,0,0,0
3283,Sanders GH,Wepo Black-on-white,2,930,1050,120,1,1,1
3283,Sanders GH,White Mound Black-on-white,4,700,850,150,1,1,1
3283,Sanders GH,"White Mountain type, Type Undifferentiated; Early",18,1000,1300,300,0,0,1
3283,Sanders GH,"White ware, Undifferentiated",2296,550,1900,1350,0,0,1
3283,Sanders GH,Wingate Black-on-red,2,1050,1225,175,1,1,1
3283,Sanders GH,Woodruff Brown,80,500,1100,600,0,0,0
3283,Sanders GH,Woodruff Smudged,694,500,1100,600,0,0,0
3284,Sanostee,Bennett Gray,11,700,850,150,0,1,0
3284,Sanostee,Blue Shale Corrugated,46,925,1150,225,0,0,0
3284,Sanostee,Brimhall Black-on-white,19,1040,1150,110,1,1,1
3284,Sanostee,Burnham Black-on-white,14,860,1000,140,1,1,1
3284,Sanostee,Captain Tom Corrugated,13,890,1000,110,0,1,0
3284,Sanostee,Chuska Black-on-white,15,1040,1125,85,1,1,1
3284,Sanostee,Chuska Indented Corrugated Gray,83,1040,1300,260,0,0,0
3284,Sanostee,"Chuska Mineral Painted White Ware, Undifferentiated",2,800,1300,500,0,1,1
3284,Sanostee,Chuska Neckbanded,5,800,950,150,0,1,0
3284,Sanostee,"Chuska Plain Gray Ware, Type Undifferentiated",17,700,925,225,0,0,0
3284,Sanostee,"Chuska White Ware type, Undifferentiated",43,800,1300,500,0,1,1
3284,Sanostee,"Cibola Black-on-white, Undifferentiated",20,550,1325,775,0,1,1
3284,Sanostee,Cibola Indented Corrugated Gray,12,1040,1400,360,0,0,0
3284,Sanostee,Cibola Neckbanded Gray,1,850,1025,175,0,1,0
3284,Sanostee,Cibola Plain Gray,24,550,1040,490,0,0,0
3284,Sanostee,Cortez Black-on-white,1,880,1060,180,1,1,1
3284,Sanostee,Deadmans (La Plata) Black-on-red,1,880,1050,170,1,1,1
3284,Sanostee,Escavada-Puerco Black-on-white,3,1000,1100,100,1,1,1
3284,Sanostee,Gallup Black-on-white,13,1040,1150,110,1,1,1
3284,Sanostee,Gray Hills Banded,5,850,950,100,0,1,0
3284,Sanostee,Hunter Corrugated,2,1100,1300,200,0,1,0
3284,Sanostee,Kana-a Black-on-white,1,825,1000,175,1,1,1
3284,Sanostee,Lino Gray (Cibola),3,550,950,400,1,0,0
3284,Sanostee,Mancos Black-on-white,3,980,1180,200,1,1,1
3284,Sanostee,Mancos Corrugated,3,920,1180,260,0,0,0
3284,Sanostee,Mancos Gray,3,880,1060,180,0,1,0
3284,Sanostee,McElmo Black-on-white,4,1060,1260,200,1,1,1
3284,Sanostee,Mesa Verde Corrugated,2,1100,1280,180,0,1,0
3284,Sanostee,Moenkopi Corrugated,1,1130,1250,120,0,1,0
3284,Sanostee,Naschitti Black-on-white,2,900,1000,100,1,1,1
3284,Sanostee,Newcomb Black-on-white,22,875,1000,125,1,1,1
3284,Sanostee,Newcomb Corrugated,4,875,950,75,0,1,0
3284,Sanostee,Red Mesa Black-on-white,35,880,1040,160,1,1,1
3284,Sanostee,"San Juan Red ware, Undifferentiated",3,700,1050,350,0,0,1
3284,Sanostee,Sheep Springs Gray,2,800,850,50,0,1,0
3284,Sanostee,Taylor Black-on-white,1,1000,1100,100,1,1,1
3284,Sanostee,Toadlena Black-on-white,9,975,1125,150,1,1,1
3284,Sanostee,Tunicha Black-on-white,4,850,900,50,1,1,1
3284,Sanostee,White Mound Black-on-white,1,700,850,150,1,1,1
3284,Sanostee,Wingate Black-on-red,1,1050,1225,175,1,1,1
3286,Singing Shelter,Bluff Black-on-red,27,800,925,125,1,1,1
3286,Singing Shelter,Chapin Black-on-white,3,575,880,305,0,1,1
3286,Singing Shelter,Chapin Gray,31,575,980,405,0,0,0
3286,Singing Shelter,Cortez Black-on-white,11,880,1060,180,1,1,1
3286,Singing Shelter,Dolores Corrugated,2,1100,1200,100,0,1,0
3286,Singing Shelter,Mancos Black-on-white,2,980,1180,200,1,1,1
3286,Singing Shelter,Mancos Corrugated,3,920,1180,260,0,0,0
3286,Singing Shelter,Mancos Gray,16,880,1060,180,0,1,0
3286,Singing Shelter,McElmo Black-on-white,5,1060,1260,200,1,1,1
3286,Singing Shelter,Mesa Verde Black-on-white,1,1180,1280,100,1,1,1
3286,Singing Shelter,"Mesa Verde BMIII/PI White Ware, Type Undifferentiated",1,575,920,345,0,1,1
3286,Singing Shelter,"Mesa Verde Corrugated Gray Ware, Undifferentiated",23,920,1280,360,0,0,0
3286,Singing Shelter,Mesa Verde Plain Gray,494,575,1020,445,0,0,0
3286,Singing Shelter,Moccasin Gray,43,800,980,180,0,1,0
3286,Singing Shelter,Piedra Black-on-white,3,800,920,120,1,1,1
3286,Singing Shelter,"San Juan Red ware, Undifferentiated",32,700,1050,350,0,0,1
3287,Skull Site,Alma Neck Banded,1,665,910,245,0,0,0
3287,Skull Site,Cebolleta Black-on-white,45,1000,1200,200,1,1,1
3287,Skull Site,Cibola Clapboard Corrugated Gray,7,900,1100,200,0,1,0
3287,Skull Site,Cibola Indented Corrugated Gray,94,1040,1400,360,0,0,0
3287,Skull Site,Cibola Plain Gray,61,550,1040,490,0,0,0
3287,Skull Site,"Cibola White Ware, Undifferentiated",122,550,1325,775,0,1,1
3287,Skull Site,Cibola Wide Neckbanded,4,850,925,75,0,1,0
3287,Skull Site,Escavada Black-on-white,2,1000,1100,100,1,1,1
3287,Skull Site,Gallup Black-on-white,6,1040,1150,110,1,1,1
3287,Skull Site,Los Lunas Smudged,3,1100,1350,250,0,0,0
3287,Skull Site,Mimbres Style I Black-on-white (Boldface),1,750,900,150,1,1,1
3287,Skull Site,"Mogollon Indented Corrugated Brown Ware, Smudged",1,1000,1400,400,0,0,0
3287,Skull Site,Mogollon Plain Brown Ware,1,300,1400,1100,0,0,0
3287,Skull Site,"Mogollon Plain Brown Ware, Smudged",3,300,1400,1100,0,0,0
3287,Skull Site,Pilares Ribbed Banded,3,1050,1150,100,0,1,0
3287,Skull Site,Pitoche Ribbed,8,1050,1150,100,0,1,0
3287,Skull Site,Puerco Black-on-red,1,1000,1175,175,1,1,1
3287,Skull Site,Red Mesa Black-on-white,3,880,1040,160,1,1,1
3287,Skull Site,Socorro Black-on-white,67,1050,1300,250,1,1,1
3287,Skull Site,Sosi Black-on-white,1,1070,1180,110,1,1,1
3287,Skull Site,St. Johns Black-on-red,1,1200,1300,100,1,1,1
3287,Skull Site,Tularosa Black-on-white,14,1180,1300,120,1,1,1
3287,Skull Site,White Mound Black-on-white,1,700,850,150,1,1,1
3287,Skull Site,"White Mountain type, Type Undifferentiated; Early",4,1000,1300,300,0,0,1
3287,Skull Site,Wingate Black-on-red,5,1050,1225,175,1,1,1
3289,Springstead,Chaco Black-on-white,2,1075,1150,75,1,1,1
3289,Springstead,"Chuska White Ware type, Undifferentiated",1,800,1300,500,0,1,1
3289,Springstead,"Cibola Gray Ware, Undifferentiated",3,550,1400,850,0,0,0
3289,Springstead,Cibola Indented Corrugated Gray,4,1040,1400,360,0,0,0
3289,Springstead,Cibola Neckbanded Gray,10,850,1025,175,0,1,0
3289,Springstead,Cibola Plain Corrugated Gray,1,900,1100,200,0,1,0
3289,Springstead,Cibola Plain Gray,5,550,1040,490,0,0,0
3289,Springstead,"Cibola White Ware, Undifferentiated",23,550,1325,775,0,1,1
3289,Springstead,Escavada Black-on-white,7,1000,1100,100,1,1,1
3289,Springstead,Gallup Black-on-white,2,1040,1150,110,1,1,1
3289,Springstead,"Gray Ware, Undifferentiated",3,400,1400,1000,0,0,0
3289,Springstead,Kiatuthlanna Black-on-white,10,850,925,75,1,1,1
3289,Springstead,Puerco Black-on-red,3,1000,1175,175,1,1,1
3289,Springstead,Red Mesa Black-on-white,30,880,1040,160,1,1,1
3289,Springstead,White Mound Black-on-white,1,700,850,150,1,1,1
3290,Squaw Springs,Black Mesa Black-on-white,1,1000,1100,100,1,1,1
3290,Squaw Springs,Chapin Gray,16,575,980,405,0,0,0
3290,Squaw Springs,Cortez Black-on-white,21,880,1060,180,1,1,1
3290,Squaw Springs,Deadmans (La Plata) Black-on-red,5,880,1050,170,1,1,1
3290,Squaw Springs,Mancos Black-on-white,20,980,1180,200,1,1,1
3290,Squaw Springs,Mancos Gray,2,880,1060,180,0,1,0
3290,Squaw Springs,McElmo Black-on-white,26,1060,1260,200,1,1,1
3290,Squaw Springs,Mesa Verde Black-on-white,3,1180,1280,100,1,1,1
3290,Squaw Springs,"Mesa Verde Corrugated Gray Ware, Undifferentiated",47,920,1280,360,0,0,0
3290,Squaw Springs,"Mesa Verde Gray ware, Undifferentiated",1,575,1280,705,0,0,0
3290,Squaw Springs,Woodruff Smudged,1,500,1100,600,0,0,0
3291,Standing Rock,Chaco Black-on-white,1,1075,1150,75,1,1,1
3291,Standing Rock,Chaco-McElmo Black-on-white (carbon paint),2,1090,1175,85,1,1,1
3291,Standing Rock,"Chuska Corrugated Gray Ware, Undifferentiated",2,890,1300,410,0,0,0
3291,Standing Rock,Chuska Indented Corrugated Gray,7,1040,1300,260,0,0,0
3291,Standing Rock,Chuska Neckbanded,4,800,950,150,0,1,0
3291,Standing Rock,"Chuska Plain Gray Ware, Type Undifferentiated",11,700,925,225,0,0,0
3291,Standing Rock,"Chuska White Ware type, Undifferentiated",1,800,1300,500,0,1,1
3291,Standing Rock,Cibola Indented Corrugated Gray,90,1040,1400,360,0,0,0
3291,Standing Rock,Cibola Neckbanded Gray,8,850,1025,175,0,1,0
3291,Standing Rock,Cibola Plain Corrugated Gray,1,900,1100,200,0,1,0
3291,Standing Rock,Cibola Plain Gray,69,550,1040,490,0,0,0
3291,Standing Rock,"Cibola White Ware, Undifferentiated",190,550,1325,775,0,1,1
3291,Standing Rock,Escavada Black-on-white,10,1000,1100,100,1,1,1
3291,Standing Rock,Escavada-Puerco Black-on-white,3,1000,1100,100,1,1,1
3291,Standing Rock,Gallup Black-on-white,34,1040,1150,110,1,1,1
3291,Standing Rock,Holbrook A Black-on-white,1,1050,1150,100,1,1,1
3291,Standing Rock,"Little Colorado White Ware, Undifferentiated",3,825,1250,425,0,1,1
3291,Standing Rock,McElmo Black-on-white,32,1060,1260,200,1,1,1
3291,Standing Rock,Mesa Verde Black-on-white,1,1180,1280,100,1,1,1
3291,Standing Rock,"Mesa Verde Corrugated Gray Ware, Undifferentiated",8,920,1280,360,0,0,0
3291,Standing Rock,Puerco Black-on-red,2,1000,1175,175,1,1,1
3291,Standing Rock,Red Mesa Black-on-white,44,880,1040,160,1,1,1
3291,Standing Rock,"San Juan Red ware, Undifferentiated",2,700,1050,350,0,0,1
3291,Standing Rock,Sanostee Black-on-red,1,825,875,50,1,1,1
3291,Standing Rock,Sanostee Red-on-Orange,1,825,875,50,1,1,1
3291,Standing Rock,St. Johns Black-on-red,1,1200,1300,100,1,1,1
3291,Standing Rock,White Mound Black-on-white,1,700,850,150,1,1,1
3291,Standing Rock,"White Mountain type, Type Undifferentiated; Early",2,1000,1300,300,0,0,1
3291,Standing Rock,Wingate Black-on-red,2,1050,1225,175,1,1,1
3292,Sundown,Black Mesa Black-on-white,19,1000,1100,100,1,1,1
3292,Sundown,"Cibola Black-on-white, Undifferentiated",121,550,1325,775,0,1,1
3292,Sundown,Cibola Indented Corrugated Gray,1,1040,1400,360,0,0,0
3292,Sundown,"Cibola White Ware, Undifferentiated",59,550,1325,775,0,1,1
3292,Sundown,Dogoszhi Black-on-white,2,1040,1210,170,1,1,1
3292,Sundown,Flagstaff Black-on-white,24,1150,1220,70,1,1,1
3292,Sundown,Gallup Black-on-white,50,1040,1150,110,1,1,1
3292,Sundown,Holbrook A Black-on-white,36,1050,1150,100,1,1,1
3292,Sundown,Holbrook B Black-on-white,159,1050,1150,100,1,1,1
3292,Sundown,Kana-a Black-on-white,66,825,1000,175,1,1,1
3292,Sundown,Lino Gray (Cibola),1,550,950,400,1,0,0
3292,Sundown,"Little Colorado Corrugated Gray Ware, Undifferentiated",1665,1050,1250,200,0,1,0
3292,Sundown,Little Colorado Indented Corrugated Gray,116,1050,1300,250,0,0,0
3292,Sundown,"Little Colorado White Ware, Undifferentiated",687,825,1250,425,0,1,1
3292,Sundown,Mogollon Indented Corrugated Brown Ware,98,1000,1400,400,0,0,0
3292,Sundown,"Mogollon Indented Corrugated Brown Ware, Smudged",445,1000,1400,400,0,0,0
3292,Sundown,Mogollon Plain Brown Ware,165,300,1400,1100,0,0,0
3292,Sundown,"Mogollon Plain Brown Ware, Smudged",499,300,1400,1100,0,0,0
3292,Sundown,Mogollon Plain Corrugated Brown Ware,11,900,1400,500,0,0,0
3292,Sundown,Padre Black-on-white,8,1100,1250,150,1,1,1
3292,Sundown,Pinto Polychrome,1,1280,1330,50,1,1,1
3292,Sundown,Puerco Black-on-red,3,1000,1175,175,1,1,1
3292,Sundown,Puerco Black-on-white,49,1030,1200,170,1,1,1
3292,Sundown,Red Mesa Black-on-white,38,880,1040,160,1,1,1
3292,Sundown,"Red Ware type, Undifferentiated",38,700,1700,1000,0,0,0
3292,Sundown,Reserve Black-on-white,3,1050,1200,150,1,1,1
3292,Sundown,Showlow Black-on-red,181,1030,1200,170,1,1,1
3292,Sundown,Showlow Red Corrugated,1,1030,1280,250,0,0,0
3292,Sundown,Snowflake Black-on-white,9,1100,1275,175,1,1,1
3292,Sundown,Sosi Black-on-white,65,1070,1180,110,1,1,1
3292,Sundown,St. Johns Black-on-red,1,1200,1300,100,1,1,1
3292,Sundown,"Tsegi Orange Ware, Undifferentiated",2,1000,1300,300,1,0,1
3292,Sundown,"Tusayan Gray Ware, Undifferentiated",246,550,1285,735,0,0,0
3292,Sundown,"Tusayan White Ware, Undifferentiated",154,825,1300,475,0,1,1
3292,Sundown,Walnut Black-on-white,83,1100,1250,150,1,1,1
3292,Sundown,"White Mountain type, Type Undifferentiated; Early",3,1000,1300,300,0,0,1
3292,Sundown,"White ware, Undifferentiated",3,550,1900,1350,0,0,1
3292,Sundown,Wingate Black-on-red,2,1050,1225,175,1,1,1
3294,Teec Nos Pos,Black Mesa Black-on-white,11,1000,1100,100,1,1,1
3294,Teec Nos Pos,Black Mesa/Sosi Black-on-white,2,1000,1180,180,1,1,1
3294,Teec Nos Pos,"Black-on-white, Undifferentiated Carbon Paint",4,550,1900,1350,0,0,1
3294,Teec Nos Pos,Blue Shale Corrugated,7,925,1150,225,0,0,0
3294,Teec Nos Pos,Burnham Black-on-white,2,860,1000,140,1,1,1
3294,Teec Nos Pos,Captain Tom Corrugated,2,890,1000,110,0,1,0
3294,Teec Nos Pos,Chuska Black-on-white,12,1040,1125,85,1,1,1
3294,Teec Nos Pos,"Chuska Clapboard Corrugated Gray, Undifferentiated",7,900,1100,200,0,1,0
3294,Teec Nos Pos,"Chuska Corrugated Gray Ware, Undifferentiated",3,890,1300,410,0,0,0
3294,Teec Nos Pos,Chuska Indented Corrugated Gray,104,1040,1300,260,0,0,0
3294,Teec Nos Pos,Chuska Neckbanded,3,800,950,150,0,1,0
3294,Teec Nos Pos,"Chuska Plain Gray Ware, Type Undifferentiated",14,700,925,225,0,0,0
3294,Teec Nos Pos,"Chuska White Ware type, Undifferentiated",16,800,1300,500,0,1,1
3294,Teec Nos Pos,Citadel Polychrome,1,1040,1200,160,1,1,1
3294,Teec Nos Pos,Cortez Black-on-white,2,880,1060,180,1,1,1
3294,Teec Nos Pos,Deadmans (La Plata) Black-on-red,22,880,1050,170,1,1,1
3294,Teec Nos Pos,Dogoszhi Black-on-white,4,1040,1210,170,1,1,1
3294,Teec Nos Pos,Escavada Black-on-white,1,1000,1100,100,1,1,1
3294,Teec Nos Pos,Gallup Black-on-white,3,1040,1150,110,1,1,1
3294,Teec Nos Pos,Gray Hills Banded,4,850,950,100,0,1,0
3294,Teec Nos Pos,Hunter Corrugated,2,1100,1300,200,0,1,0
3294,Teec Nos Pos,Mancos Black-on-white,26,980,1180,200,1,1,1
3294,Teec Nos Pos,Mancos Corrugated,16,920,1180,260,0,0,0
3294,Teec Nos Pos,Mancos/McElmo Black-on-white,8,980,1260,280,1,1,1
3294,Teec Nos Pos,McElmo Black-on-white,10,1060,1260,200,1,1,1
3294,Teec Nos Pos,McElmo/Mesa Verde Black-on-white,5,1060,1280,220,1,1,1
3294,Teec Nos Pos,Mesa Verde Black-on-white,10,1180,1280,100,1,1,1
3294,Teec Nos Pos,Mesa Verde Corrugated,2,1100,1280,180,0,1,0
3294,Teec Nos Pos,"Mesa Verde Corrugated Gray Ware, Undifferentiated",296,920,1280,360,0,0,0
3294,Teec Nos Pos,"Mesa Verde Gray ware, Undifferentiated",108,575,1280,705,0,0,0
3294,Teec Nos Pos,"Mesa Verde White Ware, Undifferentiated",68,575,1280,705,0,1,1
3294,Teec Nos Pos,Moenkopi Corrugated,2,1130,1250,120,0,1,0
3294,Teec Nos Pos,Mummy Lake Gray,2,1150,1280,130,0,1,0
3294,Teec Nos Pos,Nava Black-on-white,2,1100,1275,175,1,1,1
3294,Teec Nos Pos,Nava/Crumbled House Black-on-white,2,1100,1300,200,1,1,1
3294,Teec Nos Pos,Newcomb Black-on-white,4,875,1000,125,1,1,1
3294,Teec Nos Pos,"Plain Gray Ware, Undifferentiated",51,500,1300,800,0,0,0
3294,Teec Nos Pos,Puerco Black-on-white,1,1030,1200,170,1,1,1
3294,Teec Nos Pos,"San Juan Red ware, Undifferentiated",34,700,1050,350,0,0,1
3294,Teec Nos Pos,Sosi Black-on-white,8,1070,1180,110,1,1,1
3294,Teec Nos Pos,Toadlena Black-on-white,24,975,1125,150,1,1,1
3294,Teec Nos Pos,"Tsegi Orange Ware, Undifferentiated",17,1000,1300,300,1,0,1
3294,Teec Nos Pos,Tusayan Black-on-red,9,1045,1240,195,1,1,1
3294,Teec Nos Pos,Tusayan Clapboard Corrugated,16,1030,1100,70,0,1,0
3294,Teec Nos Pos,"Tusayan Gray Ware, Undifferentiated",2,550,1285,735,0,0,0
3294,Teec Nos Pos,Tusayan Indented Corrugated Gray,272,1040,1300,260,0,0,0
3294,Teec Nos Pos,Tusayan Plain Gray,10,600,1300,700,0,0,0
3294,Teec Nos Pos,"White ware, Undifferentiated",16,550,1900,1350,0,0,1
3296,The Twins Northeast,"Buff Ware, Undifferentiated",1,300,1450,1150,0,1,0
3296,The Twins Northeast,Captain Tom Corrugated,1,890,1000,110,0,1,0
3296,The Twins Northeast,Chaco Black-on-white,1,1075,1150,75,1,1,1
3296,The Twins Northeast,Chaco-McElmo Black-on-white (carbon paint),3,1090,1175,85,1,1,1
3296,The Twins Northeast,"Chuska Clapboard Corrugated Gray, Undifferentiated",2,900,1100,200,0,1,0
3296,The Twins Northeast,"Chuska Gray Ware, Type Undifferentiated",1,700,1300,600,0,0,0
3296,The Twins Northeast,Chuska Indented Corrugated Gray,2,1040,1300,260,0,0,0
3296,The Twins Northeast,Cibola Clapboard Corrugated Gray,7,900,1100,200,0,1,0
3296,The Twins Northeast,"Cibola Gray Ware, Undifferentiated",10,550,1400,850,0,0,0
3296,The Twins Northeast,Cibola Indented Corrugated Gray,42,1040,1400,360,0,0,0
3296,The Twins Northeast,Cibola Narrow Neckbanded,5,900,1025,125,0,1,0
3296,The Twins Northeast,"Cibola PII Gray Ware, Type Undifferentiated",4,950,1100,150,0,1,0
3296,The Twins Northeast,"Cibola PII/PIII Gray Ware, Type Undifferentiated",3,950,1300,350,0,0,0
3296,The Twins Northeast,"Cibola PII/PIII White Ware, Type Undifferentiated",95,1000,1300,300,1,1,1
3296,The Twins Northeast,"Cibola PIII Gray Ware, Type Undifferentiated",1,1100,1300,200,0,1,0
3296,The Twins Northeast,Cibola Plain Gray,9,550,1040,490,0,0,0
3296,The Twins Northeast,"Cibola White Ware, Undifferentiated",22,550,1325,775,0,1,1
3296,The Twins Northeast,Cibola Wide Neckbanded,2,850,925,75,0,1,0
3296,The Twins Northeast,Escavada Black-on-white,5,1000,1100,100,1,1,1
3296,The Twins Northeast,Gallup Black-on-white,33,1040,1150,110,1,1,1
3296,The Twins Northeast,Holbrook B Black-on-white,1,1050,1150,100,1,1,1
3296,The Twins Northeast,Kana-a Black-on-white,2,825,1000,175,1,1,1
3296,The Twins Northeast,Kiatuthlanna Black-on-white,18,850,925,75,1,1,1
3296,The Twins Northeast,Kiatuthlanna-Red Mesa Black-on-white,7,850,1040,190,1,1,1
3296,The Twins Northeast,Puerco Black-on-red,3,1000,1175,175,1,1,1
3296,The Twins Northeast,Puerco Black-on-white,4,1030,1200,170,1,1,1
3296,The Twins Northeast,Red Mesa Black-on-white,26,880,1040,160,1,1,1
3296,The Twins Northeast,"Red Ware type, Undifferentiated",2,700,1700,1000,0,0,0
3296,The Twins Northeast,"San Juan Red ware, Undifferentiated",1,700,1050,350,0,0,1
3296,The Twins Northeast,Sanostee Black-on-red,1,825,875,50,1,1,1
3296,The Twins Northeast,"White Mountain type, Type Undifferentiated; Early",3,1000,1300,300,0,0,1
3299,Three Kiva Ruin,Abajo Red-on-orange,29,760,880,120,1,1,1
3299,Three Kiva Ruin,Bluff Black-on-red,447,800,925,125,1,1,1
3299,Three Kiva Ruin,Deadmans (La Plata) Black-on-red,459,880,1050,170,1,1,1
3299,Three Kiva Ruin,Dolores Corrugated,3,1100,1200,100,0,1,0
3299,Three Kiva Ruin,Mancos Black-on-white,16,980,1180,200,1,1,1
3299,Three Kiva Ruin,Mesa Verde Black-on-white,1220,1180,1280,100,1,1,1
3299,Three Kiva Ruin,Mesa Verde Corrugated,5,1100,1280,180,0,1,0
3299,Three Kiva Ruin,Moccasin Gray,168,800,980,180,0,1,0
3299,Three Kiva Ruin,"Plain Gray Ware, Undifferentiated",27,500,1300,800,0,0,0
3299,Three Kiva Ruin,"San Juan Red ware, Undifferentiated",34,700,1050,350,0,0,1
3299,Three Kiva Ruin,Tin Cup Polychrome,4,1000,1100,100,1,1,1
3299,Three Kiva Ruin,Tusayan Polychrome,7,1110,1320,210,1,1,1
3299,Three Kiva Ruin,"Type, Undifferentiated",100,200,1900,1700,0,0,0
3299,Three Kiva Ruin,Wingate Polychrome,8,1100,1225,125,1,1,1
3301,Tla Kii,Cibola Clapboard Corrugated Gray,1,900,1100,200,0,1,0
3301,Tla Kii,Cibola Indented Corrugated Gray,2,1040,1400,360,0,0,0
3301,Tla Kii,"Cibola PII/PIII White Ware, Type Undifferentiated",212,1000,1300,300,1,1,1
3301,Tla Kii,Cibola Plain Gray,1,550,1040,490,0,0,0
3301,Tla Kii,"Cibola White Ware, Undifferentiated",183,550,1325,775,0,1,1
3301,Tla Kii,Escavada Black-on-white,8,1000,1100,100,1,1,1
3301,Tla Kii,"Little Colorado White Ware, Undifferentiated",3,825,1250,425,0,1,1
3301,Tla Kii,McDonald Corrugated,144,1150,1280,130,1,1,1
3301,Tla Kii,Mogollon Clapboard Corrugated Brown Ware,100,1000,1450,450,0,0,0
3301,Tla Kii,Mogollon Indented Corrugated Brown Ware,974,1000,1400,400,0,0,0
3301,Tla Kii,"Mogollon Indented Corrugated Brown Ware, Smudged",297,1000,1400,400,0,0,0
3301,Tla Kii,Mogollon Obliterated Corrugated Brown,305,1000,1400,400,0,0,0
3301,Tla Kii,"Mogollon Obliterated Corrugated Brown Ware, Smudged",42,1000,1400,400,0,0,0
3301,Tla Kii,Mogollon Plain Brown Ware,648,300,1400,1100,0,0,0
3301,Tla Kii,"Mogollon Plain Brown Ware, Smudged",48,300,1400,1100,0,0,0
3301,Tla Kii,"Mogollon Plain Corrugated Brown Ware, Smudged",26,900,1400,500,0,0,0
3301,Tla Kii,Mogollon Zoned Corrugated Brown Ware,9,1000,1400,400,0,0,0
3301,Tla Kii,"Mogollon Zoned Corrugated Brown Ware, Smudged",1,1000,1400,400,0,0,0
3301,Tla Kii,Pinto Polychrome,1,1280,1330,50,1,1,1
3301,Tla Kii,Puerco Black-on-red,1,1000,1175,175,1,1,1
3301,Tla Kii,Puerco Black-on-white,3,1030,1200,170,1,1,1
3301,Tla Kii,Puerco-Reserve Black-on-white,8,1030,1200,170,1,1,1
3301,Tla Kii,Red Mesa Black-on-white,8,880,1040,160,1,1,1
3301,Tla Kii,Reserve Black-on-white,7,1050,1200,150,1,1,1
3301,Tla Kii,Reserve/Tularosa Black-on-white,1,1050,1300,250,1,1,1
3301,Tla Kii,"Roosevelt Red Ware type, Undifferentiated",4,1275,1450,175,0,0,0
3301,Tla Kii,Salado Red,1,1150,1450,300,0,0,0
3301,Tla Kii,Showlow Black-on-red,8,1030,1200,170,1,1,1
3301,Tla Kii,Showlow Red,3,1000,1100,100,0,1,0
3301,Tla Kii,Snowflake Black-on-white,17,1100,1275,175,1,1,1
3301,Tla Kii,St. Johns Black-on-red,4,1200,1300,100,1,1,1
3301,Tla Kii,St. Johns Polychrome,4,1200,1300,100,1,1,1
3301,Tla Kii,Tusayan Black-on-white,1,1200,1300,100,1,1,1
3301,Tla Kii,"Tusayan White Ware, Undifferentiated",1,825,1300,475,0,1,1
3301,Tla Kii,"Type, Undifferentiated",3,200,1900,1700,0,0,0
3301,Tla Kii,White Mound Black-on-white,1,700,850,150,1,1,1
3301,Tla Kii,"White Mountain type, Type Undifferentiated; Early",16,1000,1300,300,0,0,1
3301,Tla Kii,Woodruff Brown,78,500,1100,600,0,0,0
3302,Tocito North,Bennett Gray,5,700,850,150,0,1,0
3302,Tocito North,Black Mesa Black-on-white,5,1000,1100,100,1,1,1
3302,Tocito North,Blue Shale Corrugated,88,925,1150,225,0,0,0
3302,Tocito North,Brimhall Black-on-white,21,1040,1150,110,1,1,1
3302,Tocito North,Burnham Black-on-white,20,860,1000,140,1,1,1
3302,Tocito North,Captain Tom Corrugated,16,890,1000,110,0,1,0
3302,Tocito North,Chaco-McElmo Black-on-white (carbon paint),8,1090,1175,85,1,1,1
3302,Tocito North,Chuska Black-on-white,101,1040,1125,85,1,1,1
3302,Tocito North,"Chuska Gray Ware, Type Undifferentiated",27,700,1300,600,0,0,0
3302,Tocito North,Chuska Neckbanded,37,800,950,150,0,1,0
3302,Tocito North,"Chuska PII Gray, Type Undifferentiated",25,1040,1100,60,0,1,0
3302,Tocito North,"Chuska PII/PIII Gray, Type Undifferentiated",6,1040,1300,260,0,0,0
3302,Tocito North,"Chuska White Ware type, Undifferentiated",11,800,1300,500,0,1,1
3302,Tocito North,Crozier Black-on-white,2,800,900,100,1,1,1
3302,Tocito North,Crumbled House Black-on-white,1,1150,1300,150,1,1,1
3302,Tocito North,Deadmans (La Plata) Black-on-red,3,880,1050,170,1,1,1
3302,Tocito North,Dogoszhi Black-on-white,3,1040,1210,170,1,1,1
3302,Tocito North,Gallup Black-on-white,6,1040,1150,110,1,1,1
3302,Tocito North,Gray Hills Banded,12,850,950,100,0,1,0
3302,Tocito North,Hunter Corrugated,2,1100,1300,200,0,1,0
3302,Tocito North,Kiatuthlanna Black-on-white,3,850,925,75,1,1,1
3302,Tocito North,Mancos Black-on-white,1,980,1180,200,1,1,1
3302,Tocito North,"Mesa Verde White Ware, Undifferentiated",1,575,1280,705,0,1,1
3302,Tocito North,Naschitti Black-on-white,5,900,1000,100,1,1,1
3302,Tocito North,Nava Black-on-white,13,1100,1275,175,1,1,1
3302,Tocito North,Newcomb Black-on-white,71,875,1000,125,1,1,1
3302,Tocito North,Newcomb Corrugated,8,875,950,75,0,1,0
3302,Tocito North,Pena Black-on-white,1,800,900,100,1,1,1
3302,Tocito North,Red Mesa Black-on-white,5,880,1040,160,1,1,1
3302,Tocito North,Sheep Springs Gray,3,800,850,50,0,1,0
3302,Tocito North,Sosi Black-on-white,4,1070,1180,110,1,1,1
3302,Tocito North,St. Johns Black-on-red,1,1200,1300,100,1,1,1
3302,Tocito North,Taylor Black-on-white,2,1000,1100,100,1,1,1
3302,Tocito North,Theodore Black-on-white,3,800,825,25,1,1,1
3302,Tocito North,Toadlena Black-on-white,43,975,1125,150,1,1,1
3302,Tocito North,Tocito Gray,3,825,875,50,0,1,0
3302,Tocito North,Tunicha Black-on-white,5,850,900,50,1,1,1
3302,Tocito North,Tusayan Black-on-red,6,1045,1240,195,1,1,1
3302,Tocito North,"White Mountain type, Type Undifferentiated; Early",6,1000,1300,300,0,0,1
3302,Tocito North,Wingate Black-on-red,2,1050,1225,175,1,1,1
3302,Tocito North,Wingate Polychrome,2,1100,1225,125,1,1,1
3303,Tocito South,Blue Shale Corrugated,16,925,1150,225,0,0,0
3303,Tocito South,Brimhall Black-on-white,44,1040,1150,110,1,1,1
3303,Tocito South,Captain Tom Corrugated,2,890,1000,110,0,1,0
3303,Tocito South,Chaco-McElmo Black-on-white (carbon paint),1,1090,1175,85,1,1,1
3303,Tocito South,Chuska Black-on-white,9,1040,1125,85,1,1,1
3303,Tocito South,"Chuska Corrugated Gray Ware, Undifferentiated",188,890,1300,410,0,0,0
3303,Tocito South,"Chuska PI/PII Black-on-white, Type Undifferentiated",1,700,1100,400,0,1,1
3303,Tocito South,"Chuska PII/PIII Black-on-white, Type Undifferentiated",2,900,1300,400,0,1,1
3303,Tocito South,"Chuska PIII Black-on-white, Type Undifferentiated",2,1100,1300,200,1,1,1
3303,Tocito South,Citadel Polychrome,2,1040,1200,160,1,1,1
3303,Tocito South,Deadmans (La Plata) Black-on-red,1,880,1050,170,1,1,1
3303,Tocito South,Drolet Black-on-white,1,900,1000,100,1,1,1
3303,Tocito South,Escavada Black-on-white,5,1000,1100,100,1,1,1
3303,Tocito South,Gallup Black-on-white,11,1040,1150,110,1,1,1
3303,Tocito South,Gray Hills Banded,1,850,950,100,0,1,0
3303,Tocito South,Naschitti Black-on-white,17,900,1000,100,1,1,1
3303,Tocito South,Nava Black-on-white,2,1100,1275,175,1,1,1
3303,Tocito South,Newcomb Black-on-white,6,875,1000,125,1,1,1
3303,Tocito South,Puerco Black-on-red,1,1000,1175,175,1,1,1
3303,Tocito South,Puerco Black-on-white,3,1030,1200,170,1,1,1
3303,Tocito South,Red Mesa Black-on-white,6,880,1040,160,1,1,1
3303,Tocito South,Reserve Black-on-white,2,1050,1200,150,1,1,1
3303,Tocito South,"San Juan Red ware, Undifferentiated",5,700,1050,350,0,0,1
3303,Tocito South,Sosi Black-on-white,1,1070,1180,110,1,1,1
3303,Tocito South,Taylor Black-on-white,30,1000,1100,100,1,1,1
3303,Tocito South,Toadlena Black-on-white,3,975,1125,150,1,1,1
3303,Tocito South,Tocito Gray,1,825,875,50,0,1,0
3303,Tocito South,"Tsegi Black-on-red, Undifferentiated",1,1040,1320,280,1,1,1
3303,Tocito South,"Tsegi Orange Ware, Undifferentiated",4,1000,1300,300,1,0,1
3303,Tocito South,Tunicha Black-on-white,1,850,900,50,1,1,1
3303,Tocito South,Tusayan Black-on-white,1,1200,1300,100,1,1,1
3303,Tocito South,"Tusayan PIII White Ware, Type Undifferentiated",1,1100,1300,200,1,1,1
3303,Tocito South,"White Mountain type, Type Undifferentiated; Early",7,1000,1300,300,0,0,1
3303,Tocito South,Wingate Black-on-red,5,1050,1225,175,1,1,1
3303,Tocito South,Wingate Polychrome,1,1100,1225,125,1,1,1
3304,Toh La Kai,Chaco Black-on-white,3,1075,1150,75,1,1,1
3304,Toh La Kai,Chaco-McElmo Black-on-white (carbon paint),13,1090,1175,85,1,1,1
3304,Toh La Kai,"Cibola Black-on-white, Undifferentiated",55,550,1325,775,0,1,1
3304,Toh La Kai,Cibola Indented Corrugated Gray,305,1040,1400,360,0,0,0
3304,Toh La Kai,Cibola Plain Gray,54,550,1040,490,0,0,0
3304,Toh La Kai,"Cibola White Ware, Undifferentiated",33,550,1325,775,0,1,1
3304,Toh La Kai,Escavada Black-on-white,30,1000,1100,100,1,1,1
3304,Toh La Kai,Escavada-Puerco Black-on-white,11,1000,1100,100,1,1,1
3304,Toh La Kai,Gallup Black-on-white,44,1040,1150,110,1,1,1
3304,Toh La Kai,Kiatuthlanna Black-on-white,1,850,925,75,1,1,1
3304,Toh La Kai,Klagetoh Black-on-white,5,1250,1300,50,1,1,1
3304,Toh La Kai,Little Colorado Indented Corrugated Gray,3,1050,1300,250,0,0,0
3304,Toh La Kai,"Little Colorado White Ware, Undifferentiated",2,825,1250,425,0,1,1
3304,Toh La Kai,McElmo Black-on-white,58,1060,1260,200,1,1,1
3304,Toh La Kai,Puerco Black-on-red,7,1000,1175,175,1,1,1
3304,Toh La Kai,Puerco Black-on-white,9,1030,1200,170,1,1,1
3304,Toh La Kai,Red Mesa Black-on-white,6,880,1040,160,1,1,1
3304,Toh La Kai,Walnut Black-on-white,2,1100,1250,150,1,1,1
3304,Toh La Kai,"White Mountain type, Type Undifferentiated; Early",11,1000,1300,300,0,0,1
3304,Toh La Kai,"White ware, Undifferentiated",40,550,1900,1350,0,0,1
3304,Toh La Kai,Wingate Black-on-red,20,1050,1225,175,1,1,1
3304,Toh La Kai,Wingate Polychrome,4,1100,1225,125,1,1,1
3304,Toh La Kai,Woodruff Smudged,3,500,1100,600,0,0,0
3305,Toyee,Black Mesa Black-on-white,23,1000,1100,100,1,1,1
3305,Toyee,Chaco Black-on-white,6,1075,1150,75,1,1,1
3305,Toyee,"Cibola Black-on-white, Undifferentiated",9,550,1325,775,0,1,1
3305,Toyee,"Cibola White Ware, Undifferentiated",9,550,1325,775,0,1,1
3305,Toyee,"Clapboard Corrugated Gray Ware, Undifferentiated",5,900,1100,200,0,1,0
3305,Toyee,"Corrugated Gray Ware, Undifferentiated",3,800,1400,600,0,0,0
3305,Toyee,Dogoszhi Black-on-white,18,1040,1210,170,1,1,1
3305,Toyee,Escavada Black-on-white,143,1000,1100,100,1,1,1
3305,Toyee,Flagstaff Black-on-white,1,1150,1220,70,1,1,1
3305,Toyee,Gallup Black-on-white,278,1040,1150,110,1,1,1
3305,Toyee,"Gray Ware, Undifferentiated",4,400,1400,1000,0,0,0
3305,Toyee,Holbrook A Black-on-white,2,1050,1150,100,1,1,1
3305,Toyee,"Indented Corrugated Gray Ware, Undifferentiated",20,950,1400,450,0,0,0
3305,Toyee,Jeddito Polychrome,2,1250,1300,50,1,1,1
3305,Toyee,Kana-a Black-on-white,81,825,1000,175,1,1,1
3305,Toyee,Kana'a Neckbanded,8,865,1060,195,0,1,0
3305,Toyee,Kayenta Black-on-white,1,1250,1300,50,1,1,1
3305,Toyee,Kiatuthlanna Black-on-white,23,850,925,75,1,1,1
3305,Toyee,Klagetoh Black-on-white,2,1250,1300,50,1,1,1
3305,Toyee,Leupp Black-on-white,8,1200,1250,50,1,1,1
3305,Toyee,"Little Colorado Plain Gray, Undifferentiated",3,550,1040,490,0,0,0
3305,Toyee,Moenkopi Corrugated,2,1130,1250,120,0,1,0
3305,Toyee,"Neckbanded Gray Ware, Undifferentiated",5,850,1025,175,0,1,0
3305,Toyee,Padre Black-on-white,2,1100,1250,150,1,1,1
3305,Toyee,"Plain Gray Ware, Undifferentiated",74,500,1300,800,0,0,0
3305,Toyee,Puerco Black-on-red,4,1000,1175,175,1,1,1
3305,Toyee,Puerco Black-on-white,15,1030,1200,170,1,1,1
3305,Toyee,Red Mesa Black-on-white,61,880,1040,160,1,1,1
3305,Toyee,Reserve Black-on-white,2,1050,1200,150,1,1,1
3305,Toyee,"San Juan Red ware, Undifferentiated",1,700,1050,350,0,0,1
3305,Toyee,Shato Black-on-white,5,1025,1150,125,1,1,1
3305,Toyee,Showlow Black-on-red,15,1030,1200,170,1,1,1
3305,Toyee,Showlow Red,6,1000,1100,100,0,1,0
3305,Toyee,Sosi Black-on-white,52,1070,1180,110,1,1,1
3305,Toyee,St. Johns Polychrome,5,1200,1300,100,1,1,1
3305,Toyee,Tularosa Black-on-white,4,1180,1300,120,1,1,1
3305,Toyee,Tusayan Black-on-red,2,1045,1240,195,1,1,1
3305,Toyee,Tusayan Black-on-white,32,1200,1300,100,1,1,1
3305,Toyee,Tusayan Polychrome,2,1110,1320,210,1,1,1
3305,Toyee,Tusayan Wide Clapboard Gray,8,850,925,75,0,1,0
3305,Toyee,Walnut Black-on-white,6,1100,1250,150,1,1,1
3305,Toyee,"White Mountain type, Type Undifferentiated; Early",1,1000,1300,300,0,0,1
3305,Toyee,"White ware, Undifferentiated",1,550,1900,1350,0,0,1
3305,Toyee,Wingate Black-on-red,2,1050,1225,175,1,1,1
3305,Toyee,Wingate Polychrome,1,1100,1225,125,1,1,1
3306,Tse Bee Kintsoh,Cibola Clapboard Corrugated Gray,3,900,1100,200,0,1,0
3306,Tse Bee Kintsoh,"Cibola Gray Ware, Undifferentiated",1,550,1400,850,0,0,0
3306,Tse Bee Kintsoh,Cibola Indented Corrugated Gray,8,1040,1400,360,0,0,0
3306,Tse Bee Kintsoh,Cibola Narrow Neckbanded,4,900,1025,125,0,1,0
3306,Tse Bee Kintsoh,"Cibola PII/PIII Gray Ware, Type Undifferentiated",1,950,1300,350,0,0,0
3306,Tse Bee Kintsoh,"Cibola PII/PIII White Ware, Type Undifferentiated",5,1000,1300,300,1,1,1
3306,Tse Bee Kintsoh,Escavada Black-on-white,3,1000,1100,100,1,1,1
3306,Tse Bee Kintsoh,Gallup Black-on-white,5,1040,1150,110,1,1,1
3306,Tse Bee Kintsoh,Medicine Black-on-red,1,1040,1170,130,1,1,1
3306,Tse Bee Kintsoh,"PII/PIII Gray Rim, Type Undifferentiated",2,900,1300,400,0,0,0
3306,Tse Bee Kintsoh,Puerco Black-on-white,4,1030,1200,170,1,1,1
3306,Tse Bee Kintsoh,Red Mesa Black-on-white,4,880,1040,160,1,1,1
3306,Tse Bee Kintsoh,"Red Ware type, Undifferentiated",1,700,1700,1000,0,0,0
3306,Tse Bee Kintsoh,Reserve Black-on-white,4,1050,1200,150,1,1,1
3306,Tse Bee Kintsoh,Tusayan Black-on-red,3,1045,1240,195,1,1,1
3307,Tse Chizzi,Black Mesa Black-on-white,3,1000,1100,100,1,1,1
3307,Tse Chizzi,Dogoszhi Black-on-white,7,1040,1210,170,1,1,1
3307,Tse Chizzi,Escavada Black-on-white,4,1000,1100,100,1,1,1
3307,Tse Chizzi,Gallup Black-on-white,4,1040,1150,110,1,1,1
3307,Tse Chizzi,Honani Tooled,1,850,950,100,0,1,0
3307,Tse Chizzi,Moenkopi Corrugated,3,1130,1250,120,0,1,0
3307,Tse Chizzi,Sosi Black-on-white,26,1070,1180,110,1,1,1
3307,Tse Chizzi,Tsegi Red-on-orange,1,1200,1300,100,1,1,1
3307,Tse Chizzi,Tusayan Black-on-red,1,1045,1240,195,1,1,1
3307,Tse Chizzi,Tusayan Black-on-white,1,1200,1300,100,1,1,1
3307,Tse Chizzi,Tusayan Corrugated,100,1020,1275,255,0,0,0
3307,Tse Chizzi,White Mound Black-on-white,1,700,850,150,1,1,1
3308,Tse La Vie,Blue Shale Corrugated,1,925,1150,225,0,0,0
3308,Tse La Vie,Cameron Polychrome,1,1040,1170,130,1,1,1
3308,Tse La Vie,Captain Tom Corrugated,1,890,1000,110,0,1,0
3308,Tse La Vie,Chaco Black-on-white,3,1075,1150,75,1,1,1
3308,Tse La Vie,Chaco-McElmo Black-on-white (carbon paint),33,1090,1175,85,1,1,1
3308,Tse La Vie,Chuska Black-on-white,2,1040,1125,85,1,1,1
3308,Tse La Vie,"Chuska Clapboard Corrugated Gray, Undifferentiated",2,900,1100,200,0,1,0
3308,Tse La Vie,Chuska Indented Corrugated Gray,28,1040,1300,260,0,0,0
3308,Tse La Vie,"Chuska Plain Gray Ware, Type Undifferentiated",2,700,925,225,0,0,0
3308,Tse La Vie,"Chuska White Ware type, Undifferentiated",6,800,1300,500,0,1,1
3308,Tse La Vie,Cibola Clapboard Corrugated Gray,3,900,1100,200,0,1,0
3308,Tse La Vie,"Cibola Gray Ware, Undifferentiated",1,550,1400,850,0,0,0
3308,Tse La Vie,Cibola Indented Corrugated Gray,69,1040,1400,360,0,0,0
3308,Tse La Vie,Cibola Narrow Neckbanded,6,900,1025,125,0,1,0
3308,Tse La Vie,Cibola Neckbanded Gray,15,850,1025,175,0,1,0
3308,Tse La Vie,"Cibola PII Gray Ware, Type Undifferentiated",2,950,1100,150,0,1,0
3308,Tse La Vie,"Cibola PII/PIII Gray Ware, Type Undifferentiated",4,950,1300,350,0,0,0
3308,Tse La Vie,"Cibola PII/PIII White Ware, Type Undifferentiated",91,1000,1300,300,1,1,1
3308,Tse La Vie,Cibola Plain Gray,56,550,1040,490,0,0,0
3308,Tse La Vie,"Cibola White Ware, Undifferentiated",80,550,1325,775,0,1,1
3308,Tse La Vie,Cibola Wide Neckbanded,5,850,925,75,0,1,0
3308,Tse La Vie,"Corrugated Gray Ware, Undifferentiated",137,800,1400,600,0,0,0
3308,Tse La Vie,Escavada Black-on-white,61,1000,1100,100,1,1,1
3308,Tse La Vie,Gallup Black-on-white,74,1040,1150,110,1,1,1
3308,Tse La Vie,Gray Hills Banded,6,850,950,100,0,1,0
3308,Tse La Vie,Hunter Corrugated,31,1100,1300,200,0,1,0
3308,Tse La Vie,Kiatuthlanna Black-on-white,8,850,925,75,1,1,1
3308,Tse La Vie,La Plata Black-on-white,1,550,750,200,1,1,1
3308,Tse La Vie,McElmo Black-on-white,4,1060,1260,200,1,1,1
3308,Tse La Vie,Medicine Black-on-red,1,1040,1170,130,1,1,1
3308,Tse La Vie,Moenkopi Corrugated,1,1130,1250,120,0,1,0
3308,Tse La Vie,"Neckbanded Gray Ware, Undifferentiated",17,850,1025,175,0,1,0
3308,Tse La Vie,Pinedale Black-on-white,1,1270,1320,50,1,1,1
3308,Tse La Vie,Puerco Black-on-red,17,1000,1175,175,1,1,1
3308,Tse La Vie,Puerco Black-on-white,3,1030,1200,170,1,1,1
3308,Tse La Vie,Red Mesa Black-on-white,22,880,1040,160,1,1,1
3308,Tse La Vie,"Red Ware type, Undifferentiated",6,700,1700,1000,0,0,0
3308,Tse La Vie,Reserve Black-on-white,7,1050,1200,150,1,1,1
3308,Tse La Vie,"San Juan Red ware, Undifferentiated",1,700,1050,350,0,0,1
3308,Tse La Vie,Socorro Black-on-white,3,1050,1300,250,1,1,1
3308,Tse La Vie,Sosi Black-on-white,2,1070,1180,110,1,1,1
3308,Tse La Vie,Toadlena Black-on-white,1,975,1125,150,1,1,1
3308,Tse La Vie,"Tsegi Orange Ware, Undifferentiated",3,1000,1300,300,1,0,1
3308,Tse La Vie,Tusayan Black-on-red,5,1045,1240,195,1,1,1
3308,Tse La Vie,White Mound Black-on-white,1,700,850,150,1,1,1
3308,Tse La Vie,"White Mountain type, Type Undifferentiated; Early",18,1000,1300,300,0,0,1
3308,Tse La Vie,Wingate Black-on-red,7,1050,1225,175,1,1,1
3309,Tse Lichii,Black Mesa Black-on-white,1,1000,1100,100,1,1,1
3309,Tse Lichii,Blue Shale Corrugated,1,925,1150,225,0,0,0
3309,Tse Lichii,Chaco-McElmo Black-on-white (carbon paint),10,1090,1175,85,1,1,1
3309,Tse Lichii,"Chuska Corrugated Gray Ware, Undifferentiated",1,890,1300,410,0,0,0
3309,Tse Lichii,"Chuska Plain Gray Ware, Type Undifferentiated",1,700,925,225,0,0,0
3309,Tse Lichii,"Cibola Corrugated Gray Ware, Undifferentiated",18,900,1400,500,0,0,0
3309,Tse Lichii,"Cibola Gray Ware, Undifferentiated",1,550,1400,850,0,0,0
3309,Tse Lichii,Cibola Indented Corrugated Gray,11,1040,1400,360,0,0,0
3309,Tse Lichii,Cibola Neckbanded Gray,1,850,1025,175,0,1,0
3309,Tse Lichii,"Cibola PII Gray Ware, Type Undifferentiated",1,950,1100,150,0,1,0
3309,Tse Lichii,"Cibola PII/PIII White Ware, Type Undifferentiated",7,1000,1300,300,1,1,1
3309,Tse Lichii,Cibola Plain Gray,4,550,1040,490,0,0,0
3309,Tse Lichii,"Cibola White Ware, Undifferentiated",9,550,1325,775,0,1,1
3309,Tse Lichii,"Corrugated Gray Ware, Undifferentiated",47,800,1400,600,0,0,0
3309,Tse Lichii,Escavada Black-on-white,7,1000,1100,100,1,1,1
3309,Tse Lichii,Escavada-Puerco Black-on-white,4,1000,1100,100,1,1,1
3309,Tse Lichii,Gallup Black-on-white,6,1040,1150,110,1,1,1
3309,Tse Lichii,Hunter Corrugated,2,1100,1300,200,0,1,0
3309,Tse Lichii,McElmo Black-on-white,24,1060,1260,200,1,1,1
3309,Tse Lichii,Nava Black-on-white,1,1100,1275,175,1,1,1
3309,Tse Lichii,Puerco Black-on-red,1,1000,1175,175,1,1,1
3309,Tse Lichii,Red Mesa Black-on-white,4,880,1040,160,1,1,1
3309,Tse Lichii,Showlow Red,1,1000,1100,100,0,1,0
3309,Tse Lichii,Socorro Black-on-white,1,1050,1300,250,1,1,1
3309,Tse Lichii,"White Mountain type, Type Undifferentiated; Early",5,1000,1300,300,0,0,1
3309,Tse Lichii,"White ware, Undifferentiated",18,550,1900,1350,0,0,1
3309,Tse Lichii,Wingate Black-on-red,1,1050,1225,175,1,1,1
3309,Tse Lichii,Wingate/St. Johns Black-on-red or polychrome,1,1050,1300,250,1,1,1
3310,Tseyatoh,Black Mesa Black-on-white,2,1000,1100,100,1,1,1
3310,Tseyatoh,Chaco Black-on-white,3,1075,1150,75,1,1,1
3310,Tseyatoh,"Chuska Plain Gray Ware, Type Undifferentiated",1,700,925,225,0,0,0
3310,Tseyatoh,"Cibola Gray Ware, Undifferentiated",3,550,1400,850,0,0,0
3310,Tseyatoh,Cibola Indented Corrugated Gray,8,1040,1400,360,0,0,0
3310,Tseyatoh,"Cibola PII/PIII Gray Ware, Type Undifferentiated",2,950,1300,350,0,0,0
3310,Tseyatoh,"Cibola PII/PIII White Ware, Type Undifferentiated",12,1000,1300,300,1,1,1
3310,Tseyatoh,Escavada Black-on-white,11,1000,1100,100,1,1,1
3310,Tseyatoh,"Indented Corrugated Gray Ware, Undifferentiated",5,950,1400,450,0,0,0
3310,Tseyatoh,Klagetoh Black-on-white,10,1250,1300,50,1,1,1
3310,Tseyatoh,Puerco Black-on-red,2,1000,1175,175,1,1,1
3310,Tseyatoh,Red Mesa Black-on-white,1,880,1040,160,1,1,1
3310,Tseyatoh,"Red Ware type, Undifferentiated",1,700,1700,1000,0,0,0
3310,Tseyatoh,Reserve Black-on-white,6,1050,1200,150,1,1,1
3310,Tseyatoh,Snowflake Black-on-white,1,1100,1275,175,1,1,1
3310,Tseyatoh,Sosi Black-on-white,4,1070,1180,110,1,1,1
3310,Tseyatoh,St. Johns Black-on-red,1,1200,1300,100,1,1,1
3310,Tseyatoh,St. Johns Polychrome,1,1200,1300,100,1,1,1
3310,Tseyatoh,Tusayan Corrugated,6,1020,1275,255,0,0,0
3310,Tseyatoh,"Tusayan White Ware, Undifferentiated",3,825,1300,475,0,1,1
3310,Tseyatoh,"White Mountain type, Type Undifferentiated; Early",7,1000,1300,300,0,0,1
3310,Tseyatoh,"White ware, Undifferentiated",4,550,1900,1350,0,0,1
3310,Tseyatoh,Wingate Black-on-red,5,1050,1225,175,1,1,1
3310,Tseyatoh,Wingate Polychrome,4,1100,1225,125,1,1,1
3311,Tsin Kletzin,Black Mesa/Sosi Black-on-white,5,1000,1180,180,1,1,1
3311,Tsin Kletzin,Chaco-McElmo Black-on-white (carbon paint),3,1090,1175,85,1,1,1
3311,Tsin Kletzin,"Chuska Carbon Painted White Ware, Undifferentiated",1,800,1300,500,0,1,1
3311,Tsin Kletzin,"Cibola White Ware, Undifferentiated",42,550,1325,775,0,1,1
3311,Tsin Kletzin,"Corrugated Gray Ware, Undifferentiated",196,800,1400,600,0,0,0
3311,Tsin Kletzin,Escavada Black-on-white,1,1000,1100,100,1,1,1
3311,Tsin Kletzin,Gallup Black-on-white,18,1040,1150,110,1,1,1
3311,Tsin Kletzin,"Narrow Neckbanded Gray Ware, Type Undifferentiated",3,900,1025,125,0,1,0
3311,Tsin Kletzin,"PII Gray Rim, Type Undifferentiated",5,900,1100,200,0,1,0
3311,Tsin Kletzin,"PII/PIII Gray Rim, Type Undifferentiated",1,900,1300,400,0,0,0
3311,Tsin Kletzin,"PII/PIII White Ware, Type Undifferentiated",28,900,1300,400,0,1,1
3311,Tsin Kletzin,"Plain Gray Ware, Undifferentiated",3,500,1300,800,0,0,0
3311,Tsin Kletzin,Puerco Black-on-red,1,1000,1175,175,1,1,1
3311,Tsin Kletzin,Puerco Black-on-white,13,1030,1200,170,1,1,1
3311,Tsin Kletzin,"Tsegi Orange Ware, Undifferentiated",1,1000,1300,300,1,0,1
3311,Tsin Kletzin,"White Mountain type, Type Undifferentiated; Early",1,1000,1300,300,0,0,1
3311,Tsin Kletzin,Wingate Black-on-red,1,1050,1225,175,1,1,1
3311,Tsin Kletzin,Woodruff Smudged,1,500,1100,600,0,0,0
3313,Twin Lakes,Chaco-McElmo Black-on-white (carbon paint),1,1090,1175,85,1,1,1
3313,Twin Lakes,"Chuska Plain Gray Ware, Type Undifferentiated",1,700,925,225,0,0,0
3313,Twin Lakes,Cibola Indented Corrugated Gray,16,1040,1400,360,0,0,0
3313,Twin Lakes,"Cibola PII/PIII White Ware, Type Undifferentiated",6,1000,1300,300,1,1,1
3313,Twin Lakes,"Cibola PIII Gray Ware, Type Undifferentiated",2,1100,1300,200,0,1,0
3313,Twin Lakes,Crumbled House Black-on-white,1,1150,1300,150,1,1,1
3313,Twin Lakes,Escavada Black-on-white,4,1000,1100,100,1,1,1
3313,Twin Lakes,Kiatuthlanna Black-on-white,1,850,925,75,1,1,1
3313,Twin Lakes,"PII/PIII White Ware, Type Undifferentiated",2,900,1300,400,0,1,1
3313,Twin Lakes,Puerco Black-on-white,1,1030,1200,170,1,1,1
3313,Twin Lakes,Red Mesa Black-on-white,2,880,1040,160,1,1,1
3313,Twin Lakes,Reserve Black-on-white,7,1050,1200,150,1,1,1
3313,Twin Lakes,Showlow Black-on-red,1,1030,1200,170,1,1,1
3313,Twin Lakes,St. Johns Polychrome,4,1200,1300,100,1,1,1
3313,Twin Lakes,Tularosa Black-on-white,2,1180,1300,120,1,1,1
3313,Twin Lakes,"White Mountain type, Type Undifferentiated; Early",6,1000,1300,300,0,0,1
3313,Twin Lakes,Wingate Black-on-red,2,1050,1225,175,1,1,1
3313,Twin Lakes,Wingate Polychrome,22,1100,1225,125,1,1,1
3315,Una Vida,Alma Series type,2,300,1000,700,0,0,0
3315,Una Vida,Black Mesa Black-on-white,4,1000,1100,100,1,1,1
3315,Una Vida,Black Mesa/Sosi Black-on-white,29,1000,1180,180,1,1,1
3315,Una Vida,"BMIII/PI White Ware, Type Undifferentiated",10,550,900,350,0,1,1
3315,Una Vida,Cameron Polychrome,2,1040,1170,130,1,1,1
3315,Una Vida,Chaco Black-on-white,230,1075,1150,75,1,1,1
3315,Una Vida,Chaco-McElmo Black-on-white (carbon paint),162,1090,1175,85,1,1,1
3315,Una Vida,Chuska Black-on-white,10,1040,1125,85,1,1,1
3315,Una Vida,"Chuska Carbon Painted White Ware, Undifferentiated",18,800,1300,500,0,1,1
3315,Una Vida,"Chuska Corrugated Gray Ware, Undifferentiated",17,890,1300,410,0,0,0
3315,Una Vida,"Chuska Gray Ware, Type Undifferentiated",5,700,1300,600,0,0,0
3315,Una Vida,Chuska Indented Corrugated Gray,84,1040,1300,260,0,0,0
3315,Una Vida,Chuska Neckbanded,1,800,950,150,0,1,0
3315,Una Vida,"Chuska PII Gray, Type Undifferentiated",4,1040,1100,60,0,1,0
3315,Una Vida,"Chuska PII/PIII Gray, Type Undifferentiated",2,1040,1300,260,0,0,0
3315,Una Vida,"Chuska PIII Gray, Type Undifferentiated",2,1100,1300,200,0,1,0
3315,Una Vida,"Chuska Plain Gray Ware, Type Undifferentiated",48,700,925,225,0,0,0
3315,Una Vida,"Chuska White Ware type, Undifferentiated",21,800,1300,500,0,1,1
3315,Una Vida,"Cibola BMIII/PI White Ware, Type Undifferentiated",16,550,900,350,0,1,1
3315,Una Vida,"Cibola Corrugated Gray Ware, Undifferentiated",196,900,1400,500,0,0,0
3315,Una Vida,Cibola Indented Corrugated Gray,21,1040,1400,360,0,0,0
3315,Una Vida,Cibola Narrow Neckbanded,27,900,1025,125,0,1,0
3315,Una Vida,Cibola Narrow Neckbanded Gray,1,900,1025,125,0,1,0
3315,Una Vida,Cibola Neck Indented Corrugated,1,950,1025,75,0,1,0
3315,Una Vida,"Cibola PII Gray Ware, Type Undifferentiated",6,950,1100,150,0,1,0
3315,Una Vida,"Cibola PII/PIII Gray Ware, Type Undifferentiated",3,950,1300,350,0,0,0
3315,Una Vida,"Cibola PIII Gray Ware, Type Undifferentiated",2,1100,1300,200,0,1,0
3315,Una Vida,"Cibola White Ware, Undifferentiated",1307,550,1325,775,0,1,1
3315,Una Vida,Cibola Wide Neckbanded,16,850,925,75,0,1,0
3315,Una Vida,"Corrugated Gray Ware, Undifferentiated",1161,800,1400,600,0,0,0
3315,Una Vida,Dogoszhi Black-on-white,1,1040,1210,170,1,1,1
3315,Una Vida,Escavada Black-on-white,115,1000,1100,100,1,1,1
3315,Una Vida,Gallup Black-on-white,773,1040,1150,110,1,1,1
3315,Una Vida,Gray Hills Banded,25,850,950,100,0,1,0
3315,Una Vida,"Gray Ware, Undifferentiated",68,400,1400,1000,0,0,0
3315,Una Vida,Holbrook Black-on-white,4,1050,1150,100,1,1,1
3315,Una Vida,Kana-a Black-on-white,7,825,1000,175,1,1,1
3315,Una Vida,Kiatuthlanna-Red Mesa Black-on-white,104,850,1040,190,1,1,1
3315,Una Vida,Lino Black-on-gray (Cibola),3,600,850,250,1,1,1
3315,Una Vida,Lino Gray (Cibola),3,550,950,400,1,0,0
3315,Una Vida,Lino Gray Fugitive Red [Cibola Series],7,550,850,300,1,0,0
3315,Una Vida,Mancos Black-on-white,20,980,1180,200,1,1,1
3315,Una Vida,McElmo Black-on-white,34,1060,1260,200,1,1,1
3315,Una Vida,McElmo/Mesa Verde Black-on-white,3,1060,1280,220,1,1,1
3315,Una Vida,Medicine/Tusayan Black-on-red,2,1040,1240,200,1,1,1
3315,Una Vida,Mesa Verde Black-on-white,77,1180,1280,100,1,1,1
3315,Una Vida,"Mesa Verde White Ware, Undifferentiated",23,575,1280,705,0,1,1
3315,Una Vida,"Mudware, Undifferentiated",13,400,1400,1000,0,0,0
3315,Una Vida,"Narrow Neckbanded Gray Ware, Type Undifferentiated",139,900,1025,125,0,1,0
3315,Una Vida,Nava Black-on-white,22,1100,1275,175,1,1,1
3315,Una Vida,"Neck Indented Corrugated Gray Ware, Type Undifferentiated",3160,950,1025,75,0,1,0
3315,Una Vida,Newcomb or Burnham Black-on-white,6,860,1000,140,1,1,1
3315,Una Vida,"PII Gray Rim, Type Undifferentiated",185,900,1100,200,0,1,0
3315,Una Vida,"PII/PIII Gray Rim, Type Undifferentiated",882,900,1300,400,0,0,0
3315,Una Vida,"PII/PIII White Ware, Type Undifferentiated",917,900,1300,400,0,1,1
3315,Una Vida,"PIII Gray Rim, Type Undifferentiated",99,1100,1300,200,0,1,0
3315,Una Vida,"Plain Gray Ware, Undifferentiated",775,500,1300,800,0,0,0
3315,Una Vida,Puerco Black-on-red,13,1000,1175,175,1,1,1
3315,Una Vida,Puerco Black-on-white,239,1030,1200,170,1,1,1
3315,Una Vida,Red Mesa Black-on-white,1004,880,1040,160,1,1,1
3315,Una Vida,"Red Ware type, Undifferentiated",169,700,1700,1000,0,0,0
3315,Una Vida,Reserve Black-on-white,2,1050,1200,150,1,1,1
3315,Una Vida,"San Juan Red ware, Undifferentiated",10,700,1050,350,0,0,1
3315,Una Vida,Socorro Black-on-white,10,1050,1300,250,1,1,1
3315,Una Vida,St. Johns Black-on-red or Polychrome,1,1200,1300,100,1,1,1
3315,Una Vida,Toadlena Black-on-white,35,975,1125,150,1,1,1
3315,Una Vida,"Tsegi Orange Ware, Undifferentiated",9,1000,1300,300,1,0,1
3315,Una Vida,Tularosa Black-on-white,2,1180,1300,120,1,1,1
3315,Una Vida,Tunicha Black-on-white,4,850,900,50,1,1,1
3315,Una Vida,Tusayan Polychrome,9,1110,1320,210,1,1,1
3315,Una Vida,"Tusayan White Ware, Undifferentiated",5,825,1300,475,0,1,1
3315,Una Vida,"Type, Undifferentiated",4,200,1900,1700,0,0,0
3315,Una Vida,White Mound Black-on-white,1,700,850,150,1,1,1
3315,Una Vida,"White Mountain type, Type Undifferentiated; Early",12,1000,1300,300,0,0,1
3315,Una Vida,"White ware, Undifferentiated",871,550,1900,1350,0,0,1
3315,Una Vida,"Wide Neckbanded Gray Ware, Type Undifferentiated",59,850,925,75,0,1,0
3315,Una Vida,Wingate Black-on-red,13,1050,1225,175,1,1,1
3315,Una Vida,Woodruff Smudged,142,500,1100,600,0,0,0
3316,Upper Kin Klizhin,Black Mesa Black-on-white,4,1000,1100,100,1,1,1
3316,Upper Kin Klizhin,Chaco Black-on-white,9,1075,1150,75,1,1,1
3316,Upper Kin Klizhin,Chaco-McElmo Black-on-white (carbon paint),8,1090,1175,85,1,1,1
3316,Upper Kin Klizhin,Chuska Indented Corrugated Gray,122,1040,1300,260,0,0,0
3316,Upper Kin Klizhin,"Chuska Plain Gray Ware, Type Undifferentiated",20,700,925,225,0,0,0
3316,Upper Kin Klizhin,"Chuska White Ware type, Undifferentiated",10,800,1300,500,0,1,1
3316,Upper Kin Klizhin,Cibola Clapboard Corrugated Gray,24,900,1100,200,0,1,0
3316,Upper Kin Klizhin,"Cibola Corrugated Gray Ware, Undifferentiated",50,900,1400,500,0,0,0
3316,Upper Kin Klizhin,Cibola Indented Corrugated Gray,596,1040,1400,360,0,0,0
3316,Upper Kin Klizhin,Cibola Neckbanded Gray,10,850,1025,175,0,1,0
3316,Upper Kin Klizhin,Cibola Plain Gray,379,550,1040,490,0,0,0
3316,Upper Kin Klizhin,"Cibola White Ware, Undifferentiated",236,550,1325,775,0,1,1
3316,Upper Kin Klizhin,Cibola Wide Neckbanded,28,850,925,75,0,1,0
3316,Upper Kin Klizhin,Escavada Black-on-white,132,1000,1100,100,1,1,1
3316,Upper Kin Klizhin,Gallup Black-on-white,283,1040,1150,110,1,1,1
3316,Upper Kin Klizhin,Hunter Corrugated,1,1100,1300,200,0,1,0
3316,Upper Kin Klizhin,Kana-a Black-on-white,2,825,1000,175,1,1,1
3316,Upper Kin Klizhin,La Plata Black-on-white,14,550,750,200,1,1,1
3316,Upper Kin Klizhin,Lino Black-on-gray (Cibola),1,600,850,250,1,1,1
3316,Upper Kin Klizhin,McElmo Black-on-white,7,1060,1260,200,1,1,1
3316,Upper Kin Klizhin,"Mesa Verde White Ware, Undifferentiated",3,575,1280,705,0,1,1
3316,Upper Kin Klizhin,Puerco Black-on-red,8,1000,1175,175,1,1,1
3316,Upper Kin Klizhin,Red Mesa Black-on-white,97,880,1040,160,1,1,1
3316,Upper Kin Klizhin,"San Juan Red ware, Undifferentiated",13,700,1050,350,0,0,1
3316,Upper Kin Klizhin,"Tusayan White Ware, Undifferentiated",1,825,1300,475,0,1,1
3316,Upper Kin Klizhin,"White Mountain type, Type Undifferentiated; Early",4,1000,1300,300,0,0,1
3316,Upper Kin Klizhin,"White ware, Undifferentiated",213,550,1900,1350,0,0,1
3316,Upper Kin Klizhin,Wingate Black-on-red,2,1050,1225,175,1,1,1
3317,Upper Kin Nizhoni,Cibola Indented Corrugated Gray,34,1040,1400,360,0,0,0
3317,Upper Kin Nizhoni,Cibola Plain Gray,2,550,1040,490,0,0,0
3317,Upper Kin Nizhoni,Escavada-Puerco Black-on-white,3,1000,1100,100,1,1,1
3317,Upper Kin Nizhoni,Gallup Black-on-white,2,1040,1150,110,1,1,1
3317,Upper Kin Nizhoni,Red Mesa Black-on-white,3,880,1040,160,1,1,1
3317,Upper Kin Nizhoni,"White Mountain type, Type Undifferentiated; Early",1,1000,1300,300,0,0,1
3319,Vidal Canyon,"Cibola Corrugated Gray Ware, Undifferentiated",12,900,1400,500,0,0,0
3319,Vidal Canyon,Cibola Indented Corrugated Gray,24,1040,1400,360,0,0,0
3319,Vidal Canyon,Cibola Plain Gray,30,550,1040,490,0,0,0
3319,Vidal Canyon,"Cibola White Ware, Undifferentiated",27,550,1325,775,0,1,1
3319,Vidal Canyon,Gallup Black-on-white,7,1040,1150,110,1,1,1
3319,Vidal Canyon,Puerco Black-on-white,15,1030,1200,170,1,1,1
3319,Vidal Canyon,Red Mesa Black-on-white,17,880,1040,160,1,1,1
3319,Vidal Canyon,"White Mountain type, Type Undifferentiated; Early",1,1000,1300,300,0,0,1
3319,Vidal Canyon,"White ware, Undifferentiated",2,550,1900,1350,0,0,1
3320,Wallace Ruin,Abajo Red-on-orange,29,760,880,120,1,1,1
3320,Wallace Ruin,Bluff Black-on-red,67,800,925,125,1,1,1
3320,Wallace Ruin,Chaco Black-on-white,259,1075,1150,75,1,1,1
3320,Wallace Ruin,Chaco-McElmo Black-on-white (carbon paint),20,1090,1175,85,1,1,1
3320,Wallace Ruin,Chapin Black-on-white,3,575,880,305,0,1,1
3320,Wallace Ruin,"Cibola White Ware, Undifferentiated",36,550,1325,775,0,1,1
3320,Wallace Ruin,Cortez Black-on-white,604,880,1060,180,1,1,1
3320,Wallace Ruin,Deadmans (La Plata) Black-on-red,78,880,1050,170,1,1,1
3320,Wallace Ruin,"Decorated Type, Undifferentiated",724,300,1900,1600,0,0,1
3320,Wallace Ruin,Escavada Black-on-white,20,1000,1100,100,1,1,1
3320,Wallace Ruin,Gallup Black-on-white,4,1040,1150,110,1,1,1
3320,Wallace Ruin,Kiatuthlanna Black-on-white,1,850,925,75,1,1,1
3320,Wallace Ruin,Mancos Black-on-white,4082,980,1180,200,1,1,1
3320,Wallace Ruin,McElmo Black-on-white,2754,1060,1260,200,1,1,1
3320,Wallace Ruin,Mesa Verde Black-on-white,1753,1180,1280,100,1,1,1
3320,Wallace Ruin,"Mesa Verde White Ware, Undifferentiated",9280,575,1280,705,0,1,1
3320,Wallace Ruin,Piedra Black-on-white,30,800,920,120,1,1,1
3320,Wallace Ruin,Puerco Black-on-red,15,1000,1175,175,1,1,1
3320,Wallace Ruin,Red Mesa Black-on-white,51,880,1040,160,1,1,1
3320,Wallace Ruin,"Red Ware type, Undifferentiated",15,700,1700,1000,0,0,0
3320,Wallace Ruin,"San Juan Red ware, Undifferentiated",165,700,1050,350,0,0,1
3320,Wallace Ruin,Socorro Black-on-white,1,1050,1300,250,1,1,1
3320,Wallace Ruin,St. Johns Black-on-red,2,1200,1300,100,1,1,1
3320,Wallace Ruin,Tusayan Black-on-red,132,1045,1240,195,1,1,1
3320,Wallace Ruin,Tusayan Polychrome,44,1110,1320,210,1,1,1
3320,Wallace Ruin,"Tusayan White Ware, Undifferentiated",17,825,1300,475,0,1,1
3320,Wallace Ruin,Wingate Black-on-red,42,1050,1225,175,1,1,1
3320,Wallace Ruin,Wingate Polychrome,5,1100,1225,125,1,1,1
3321,Wancura-Johnson GK,Abajo Red-on-orange,1,760,880,120,1,1,1
3321,Wancura-Johnson GK,Bluff Black-on-red,15,800,925,125,1,1,1
3321,Wancura-Johnson GK,Chapin Gray,4,575,980,405,0,0,0
3321,Wancura-Johnson GK,Mancos Gray,88,880,1060,180,0,1,0
3321,Wancura-Johnson GK,"Mesa Verde Corrugated Gray Ware, Undifferentiated",5,920,1280,360,0,0,0
3321,Wancura-Johnson GK,"Mesa Verde Gray ware, Undifferentiated",621,575,1280,705,0,0,0
3321,Wancura-Johnson GK,Mesa Verde Neckbanded Gray,13,800,1060,260,0,0,0
3321,Wancura-Johnson GK,"Mesa Verde PI White Ware, Type Undifferentiated",26,750,920,170,1,1,1
3321,Wancura-Johnson GK,Moccasin Gray,57,800,980,180,0,1,0
3321,Wancura-Johnson GK,Piedra Black-on-white,5,800,920,120,1,1,1
3321,Wancura-Johnson GK,"San Juan Red ware, Undifferentiated",20,700,1050,350,0,0,1
3321,Wancura-Johnson GK,White Mesa Black-on-white,1,850,1000,150,1,1,1
3326,Whirlwind House,Chaco-McElmo Black-on-white (carbon paint),1,1090,1175,85,1,1,1
3326,Whirlwind House,Chuska Black-on-white,1,1040,1125,85,1,1,1
3326,Whirlwind House,Chuska Indented Corrugated Gray,49,1040,1300,260,0,0,0
3326,Whirlwind House,"Chuska White Ware type, Undifferentiated",6,800,1300,500,0,1,1
3326,Whirlwind House,"Cibola Black-on-white, Undifferentiated",26,550,1325,775,0,1,1
3326,Whirlwind House,Cibola Indented Corrugated Gray,38,1040,1400,360,0,0,0
3326,Whirlwind House,Escavada-Puerco Black-on-white,5,1000,1100,100,1,1,1
3326,Whirlwind House,Gallup Black-on-white,6,1040,1150,110,1,1,1
3326,Whirlwind House,Toadlena Black-on-white,2,975,1125,150,1,1,1
3326,Whirlwind House,"White Mountain type, Type Undifferentiated; Early",2,1000,1300,300,0,0,1
3327,Whitewater,Chaco Black-on-white,4,1075,1150,75,1,1,1
3327,Whitewater,Cibola Clapboard Corrugated Gray,25,900,1100,200,0,1,0
3327,Whitewater,"Cibola Gray Ware, Undifferentiated",5,550,1400,850,0,0,0
3327,Whitewater,Cibola Indented Corrugated Gray,273,1040,1400,360,0,0,0
3327,Whitewater,Cibola Neckbanded Gray,2,850,1025,175,0,1,0
3327,Whitewater,"Cibola PI/PII White Ware, Type Undifferentiated",7,700,1100,400,0,1,1
3327,Whitewater,"Cibola PII White Ware, Type Undifferentiated",42,880,1100,220,1,1,1
3327,Whitewater,"Cibola PII/PIII White Ware, Type Undifferentiated",38,1000,1300,300,1,1,1
3327,Whitewater,Cibola Plain Gray,81,550,1040,490,0,0,0
3327,Whitewater,"Cibola White Ware, Undifferentiated",38,550,1325,775,0,1,1
3327,Whitewater,Cibola Wide Neckbanded,4,850,925,75,0,1,0
3327,Whitewater,Escavada Black-on-white,69,1000,1100,100,1,1,1
3327,Whitewater,Gallup Black-on-white,16,1040,1150,110,1,1,1
3327,Whitewater,Holbrook A Black-on-white,1,1050,1150,100,1,1,1
3327,Whitewater,Holbrook B Black-on-white,3,1050,1150,100,1,1,1
3327,Whitewater,Kiatuthlanna Black-on-white,9,850,925,75,1,1,1
3327,Whitewater,Lino Gray (Cibola),1,550,950,400,1,0,0
3327,Whitewater,Lino Gray Fugitive Red [Cibola Series],2,550,850,300,1,0,0
3327,Whitewater,Little Colorado Indented Corrugated Gray,8,1050,1300,250,0,0,0
3327,Whitewater,"Little Colorado White Ware, Undifferentiated",5,825,1250,425,0,1,1
3327,Whitewater,"Mogollon Corrugated Brown Ware, Undifferentiated",1,800,1400,600,0,0,0
3327,Whitewater,Mogollon Red-on-brown,1,775,900,125,1,1,1
3327,Whitewater,Puerco Black-on-red,8,1000,1175,175,1,1,1
3327,Whitewater,Puerco Black-on-white,10,1030,1200,170,1,1,1
3327,Whitewater,Red Mesa Black-on-white,25,880,1040,160,1,1,1
3327,Whitewater,Reserve Black-on-white,50,1050,1200,150,1,1,1
3327,Whitewater,"San Juan Black-on-red, Undifferentiated",1,700,1050,350,0,1,1
3327,Whitewater,Showlow Black-on-red,2,1030,1200,170,1,1,1
3327,Whitewater,Showlow Red,4,1000,1100,100,0,1,0
3327,Whitewater,Showlow Red Corrugated,1,1030,1280,250,0,0,0
3327,Whitewater,Sosi Black-on-white,1,1070,1180,110,1,1,1
3327,Whitewater,St. Josephs Black-on-White,1,825,1050,225,1,1,1
3327,Whitewater,"Tusayan White Ware, Undifferentiated",4,825,1300,475,0,1,1
3327,Whitewater,White Mound Black-on-white,3,700,850,150,1,1,1
3327,Whitewater,"White Mountain type, Type Undifferentiated; Early",7,1000,1300,300,0,0,1
3327,Whitewater,"White ware, Undifferentiated",3,550,1900,1350,0,0,1
3327,Whitewater,Wingate Black-on-red,4,1050,1225,175,1,1,1
3327,Whitewater,Woodruff Brown,5,500,1100,600,0,0,0
3327,Whitewater,Woodruff Smudged,5,500,1100,600,0,0,0
3329,Willow Canyon--San Juan Basin,Bluff Black-on-red,1,800,925,125,1,1,1
3329,Willow Canyon--San Juan Basin,"Chuska Carbon Painted White Ware, Undifferentiated",2,800,1300,500,0,1,1
3329,Willow Canyon--San Juan Basin,"Chuska Mineral Painted White Ware, Undifferentiated",4,800,1300,500,0,1,1
3329,Willow Canyon--San Juan Basin,Chuska Neckbanded,52,800,950,150,0,1,0
3329,Willow Canyon--San Juan Basin,"Chuska Plain Gray Ware, Type Undifferentiated",206,700,925,225,0,0,0
3329,Willow Canyon--San Juan Basin,"Chuska White Ware type, Undifferentiated",50,800,1300,500,0,1,1
3329,Willow Canyon--San Juan Basin,Cibola Neckbanded Gray,10,850,1025,175,0,1,0
3329,Willow Canyon--San Juan Basin,Cibola Plain Gray,41,550,1040,490,0,0,0
3329,Willow Canyon--San Juan Basin,"Cibola White Ware, Undifferentiated",37,550,1325,775,0,1,1
3329,Willow Canyon--San Juan Basin,Cibola Wide Neckbanded,1,850,925,75,0,1,0
3329,Willow Canyon--San Juan Basin,Deadmans (La Plata) Black-on-red,8,880,1050,170,1,1,1
3329,Willow Canyon--San Juan Basin,Drolet Black-on-white,4,900,1000,100,1,1,1
3329,Willow Canyon--San Juan Basin,Gray Hills Banded,4,850,950,100,0,1,0
3329,Willow Canyon--San Juan Basin,Kana-a Black-on-white,6,825,1000,175,1,1,1
3329,Willow Canyon--San Juan Basin,Kiatuthlanna Black-on-white,6,850,925,75,1,1,1
3329,Willow Canyon--San Juan Basin,La Plata Black-on-white,1,550,750,200,1,1,1
3329,Willow Canyon--San Juan Basin,Lino Black-on-gray (Tusayan),5,600,850,250,1,1,1
3329,Willow Canyon--San Juan Basin,Lino Gray (Cibola),1,550,950,400,1,0,0
3329,Willow Canyon--San Juan Basin,Lino Gray (trachyte),1,550,950,400,0,0,0
3329,Willow Canyon--San Juan Basin,Naschitti Black-on-white,26,900,1000,100,1,1,1
3329,Willow Canyon--San Juan Basin,Pena Black-on-white,18,800,900,100,1,1,1
3329,Willow Canyon--San Juan Basin,Piedra Black-on-white,2,800,920,120,1,1,1
3329,Willow Canyon--San Juan Basin,"PII/PIII White Ware, Type Undifferentiated",2,900,1300,400,0,1,1
3329,Willow Canyon--San Juan Basin,Red Mesa Black-on-white,52,880,1040,160,1,1,1
3329,Willow Canyon--San Juan Basin,Sanostee Black-on-red,2,825,875,50,1,1,1
3329,Willow Canyon--San Juan Basin,Sheep Springs Gray,30,800,850,50,0,1,0
3329,Willow Canyon--San Juan Basin,Theodore Black-on-white,2,800,825,25,1,1,1
3329,Willow Canyon--San Juan Basin,Tunicha Black-on-white,12,850,900,50,1,1,1
3329,Willow Canyon--San Juan Basin,White Mound Black-on-white,8,700,850,150,1,1,1
3329,Willow Canyon--San Juan Basin,"White ware, Undifferentiated",12,550,1900,1350,0,0,1
3330,Wolye Adin,Black Mesa Black-on-white,1,1000,1100,100,1,1,1
3330,Wolye Adin,Cebolleta Black-on-white,2,1000,1200,200,1,1,1
3330,Wolye Adin,Cibola Indented Corrugated Gray,8,1040,1400,360,0,0,0
3330,Wolye Adin,Cibola Wide Neckbanded,3,850,925,75,0,1,0
3330,Wolye Adin,Kana-a Black-on-white,12,825,1000,175,1,1,1
3330,Wolye Adin,Kia-ko Black-on-white,2,1100,1150,50,1,1,1
3330,Wolye Adin,Kiatuthlanna Black-on-white,20,850,925,75,1,1,1
3330,Wolye Adin,Klagetoh Black-on-white,4,1250,1300,50,1,1,1
3330,Wolye Adin,La Plata Black-on-white,2,550,750,200,1,1,1
3330,Wolye Adin,Lino Gray (Cibola),120,550,950,400,1,0,0
3330,Wolye Adin,"Little Colorado Corrugated Gray Ware, Undifferentiated",45,1050,1250,200,0,1,0
3330,Wolye Adin,Puerco Black-on-red,2,1000,1175,175,1,1,1
3330,Wolye Adin,Puerco Black-on-white,177,1030,1200,170,1,1,1
3330,Wolye Adin,Red Mesa Black-on-white,43,880,1040,160,1,1,1
3330,Wolye Adin,Reserve Black-on-white,1,1050,1200,150,1,1,1
3330,Wolye Adin,St. Johns Black-on-red,7,1200,1300,100,1,1,1
3330,Wolye Adin,Tularosa Black-on-white,1,1180,1300,120,1,1,1
3330,Wolye Adin,Tusayan Corrugated,49,1020,1275,255,0,0,0
3330,Wolye Adin,Tusayan Plain Gray,2,600,1300,700,0,0,0
3330,Wolye Adin,"Type, Undifferentiated",41,200,1900,1700,0,0,0
3330,Wolye Adin,White Mound Black-on-white,37,700,850,150,1,1,1
3330,Wolye Adin,Wingate Black-on-red,10,1050,1225,175,1,1,1
3330,Wolye Adin,Wingate Polychrome,3,1100,1225,125,1,1,1
3330,Wolye Adin,Woodruff Brown,9,500,1100,600,0,0,0
3332,Yellow Jacket,Abajo Red-on-orange,4,760,880,120,1,1,1
3332,Yellow Jacket,Bluff Black-on-red,8,800,925,125,1,1,1
3332,Yellow Jacket,Chapin Black-on-white,4,575,880,305,0,1,1
3332,Yellow Jacket,Chapin Gray,5,575,980,405,0,0,0
3332,Yellow Jacket,Citadel Polychrome,1,1040,1200,160,1,1,1
3332,Yellow Jacket,Cortez Black-on-white,2,880,1060,180,1,1,1
3332,Yellow Jacket,Deadmans (La Plata) Black-on-red,15,880,1050,170,1,1,1
3332,Yellow Jacket,Dogoszhi Polychrome,2,1040,1320,280,1,1,1
3332,Yellow Jacket,Gallup Black-on-white,5,1040,1150,110,1,1,1
3332,Yellow Jacket,Mancos Black-on-white,1116,980,1180,200,1,1,1
3332,Yellow Jacket,Mancos Corrugated,151,920,1180,260,0,0,0
3332,Yellow Jacket,Mancos Gray,5,880,1060,180,0,1,0
3332,Yellow Jacket,McElmo Black-on-white,412,1060,1260,200,1,1,1
3332,Yellow Jacket,Medicine Black-on-red,1,1040,1170,130,1,1,1
3332,Yellow Jacket,Mesa Verde Black-on-white,621,1180,1280,100,1,1,1
3332,Yellow Jacket,"Mesa Verde BMIII/PI White Ware, Type Undifferentiated",53,575,920,345,0,1,1
3332,Yellow Jacket,Mesa Verde Corrugated,424,1100,1280,180,0,1,0
3332,Yellow Jacket,"Mesa Verde Corrugated Gray Ware, Undifferentiated",40103,920,1280,360,0,0,0
3332,Yellow Jacket,"Mesa Verde Gray ware, Undifferentiated",1101,575,1280,705,0,0,0
3332,Yellow Jacket,"Mesa Verde PII White Ware, Type Undifferentiated",28,920,1100,180,1,1,1
3332,Yellow Jacket,"Mesa Verde PII/PIII White Ware, Type Undifferentiated",16960,920,1280,360,0,1,1
3332,Yellow Jacket,"Mesa Verde PIII White Ware, Type Undifferentiated",4786,1100,1280,180,1,1,1
3332,Yellow Jacket,"Mesa Verde White Ware, Undifferentiated",118,575,1280,705,0,1,1
3332,Yellow Jacket,Moccasin Gray,4,800,980,180,0,1,0
3332,Yellow Jacket,Piedra Black-on-white,1,800,920,120,1,1,1
3332,Yellow Jacket,Puerco Black-on-red,1,1000,1175,175,1,1,1
3332,Yellow Jacket,"Red Ware type, Undifferentiated",16,700,1700,1000,0,0,0
3332,Yellow Jacket,"San Juan Red ware, Undifferentiated",38,700,1050,350,0,0,1
3332,Yellow Jacket,St. Johns Polychrome,1,1200,1300,100,1,1,1
3332,Yellow Jacket,"Tsegi Orange Ware, Undifferentiated",20,1000,1300,300,1,0,1
3332,Yellow Jacket,Tusayan Black-on-red,9,1045,1240,195,1,1,1
3332,Yellow Jacket,Tusayan Polychrome,5,1110,1320,210,1,1,1
3332,Yellow Jacket,"Type, Undifferentiated",1,200,1900,1700,0,0,0
3332,Yellow Jacket,"White Mountain type, Type Undifferentiated; Early",4,1000,1300,300,0,0,1
3332,Yellow Jacket,Wingate Black-on-red,14,1050,1225,175,1,1,1
3332,Yellow Jacket,Wingate Polychrome,4,1100,1225,125,1,1,1
3333,Yucca House,Mancos Corrugated,4,920,1180,260,0,0,0
3333,Yucca House,McElmo Black-on-white,24,1060,1260,200,1,1,1
3333,Yucca House,Mesa Verde Black-on-white,42,1180,1280,100,1,1,1
3333,Yucca House,"Mesa Verde BMIII/PI White Ware, Type Undifferentiated",2,575,920,345,0,1,1
3333,Yucca House,Mesa Verde Corrugated,28,1100,1280,180,0,1,0
3333,Yucca House,"Mesa Verde Corrugated Gray Ware, Undifferentiated",766,920,1280,360,0,0,0
3333,Yucca House,"Mesa Verde Gray ware, Undifferentiated",36,575,1280,705,0,0,0
3333,Yucca House,"Mesa Verde PII White Ware, Type Undifferentiated",2,920,1100,180,1,1,1
3333,Yucca House,"Mesa Verde PII/PIII White Ware, Type Undifferentiated",205,920,1280,360,0,1,1
3333,Yucca House,"Mesa Verde PIII White Ware, Type Undifferentiated",360,1100,1280,180,1,1,1
3333,Yucca House,"Mesa Verde White Ware, Undifferentiated",66,575,1280,705,0,1,1
3334,Escalante GH,Abajo Red-on-orange,4,760,880,120,1,1,1
3334,Escalante GH,Chapin Black-on-white,1,575,880,305,0,1,1
3334,Escalante GH,Chapin Gray,22,575,980,405,0,0,0
3334,Escalante GH,Cortez Black-on-white,4,880,1060,180,1,1,1
3334,Escalante GH,Deadmans (La Plata) Black-on-red,12,880,1050,170,1,1,1
3334,Escalante GH,Dolores Corrugated,23,1100,1200,100,0,1,0
3334,Escalante GH,Flagstaff Black-on-white,45,1150,1220,70,1,1,1
3334,Escalante GH,Gallup Black-on-white,2,1040,1150,110,1,1,1
3334,Escalante GH,"Gray Ware, Undifferentiated",1,400,1400,1000,0,0,0
3334,Escalante GH,Mancos Black-on-white,1643,980,1180,200,1,1,1
3334,Escalante GH,Mancos Corrugated,7,920,1180,260,0,0,0
3334,Escalante GH,Mancos Gray,16,880,1060,180,0,1,0
3334,Escalante GH,McElmo Black-on-white,526,1060,1260,200,1,1,1
3334,Escalante GH,Medicine Black-on-red,9,1040,1170,130,1,1,1
3334,Escalante GH,Mesa Verde Black-on-white,8,1180,1280,100,1,1,1
3334,Escalante GH,Mesa Verde Corrugated,133,1100,1280,180,0,1,0
3334,Escalante GH,"Mesa Verde Corrugated Gray Ware, Undifferentiated",4904,920,1280,360,0,0,0
3334,Escalante GH,"Mesa Verde Gray ware, Undifferentiated",6,575,1280,705,0,0,0
3334,Escalante GH,"Mesa Verde PII/PIII White Ware, Type Undifferentiated",38,920,1280,360,0,1,1
3334,Escalante GH,Mesa Verde Plain Gray,1556,575,1020,445,0,0,0
3334,Escalante GH,Moccasin Gray,3,800,980,180,0,1,0
3334,Escalante GH,Mummy Lake Gray,3,1150,1280,130,0,1,0
3334,Escalante GH,Piedra Black-on-white,22,800,920,120,1,1,1
3334,Escalante GH,Puerco Black-on-red,5,1000,1175,175,1,1,1
3334,Escalante GH,"Red Ware type, Undifferentiated",22,700,1700,1000,0,0,0
3334,Escalante GH,"San Juan Red ware, Undifferentiated",2,700,1050,350,0,0,1
3334,Escalante GH,Sosi Black-on-white,29,1070,1180,110,1,1,1
3334,Escalante GH,Tin Cup Polychrome,1,1000,1100,100,1,1,1
3334,Escalante GH,"Tsegi Orange Ware, Undifferentiated",42,1000,1300,300,1,0,1
3334,Escalante GH,Tusayan Black-on-red,29,1045,1240,195,1,1,1
3334,Escalante GH,Tusayan Polychrome,158,1110,1320,210,1,1,1
3334,Escalante GH,"Type, Undifferentiated",11,200,1900,1700,0,0,0
3334,Escalante GH,"White ware, Undifferentiated",1210,550,1900,1350,0,0,1
3334,Escalante GH,Wingate Black-on-red,2,1050,1225,175,1,1,1
3335,LA 35420,"Chuska Corrugated Gray Ware, Undifferentiated",2,890,1300,410,0,0,0
3335,LA 35420,"Cibola Corrugated Gray Ware, Undifferentiated",19,900,1400,500,0,0,0
3335,LA 35420,Cibola Neckbanded Gray,2,850,1025,175,0,1,0
3335,LA 35420,Cibola Plain Gray,18,550,1040,490,0,0,0
3335,LA 35420,"Corrugated Gray Ware, Undifferentiated",23,800,1400,600,0,0,0
3335,LA 35420,Escavada Black-on-white,3,1000,1100,100,1,1,1
3335,LA 35420,Gallup Black-on-white,12,1040,1150,110,1,1,1
3335,LA 35420,Puerco Black-on-red,2,1000,1175,175,1,1,1
3335,LA 35420,Red Mesa Black-on-white,16,880,1040,160,1,1,1
3335,LA 35420,"San Juan Red ware, Undifferentiated",1,700,1050,350,0,0,1
3335,LA 35420,Sanostee Black-on-red,1,825,875,50,1,1,1
3335,LA 35420,"White Mountain type, Type Undifferentiated; Early",1,1000,1300,300,0,0,1
3335,LA 35420,"White ware, Undifferentiated",34,550,1900,1350,0,0,1
3335,LA 35420,Wingate Black-on-red,1,1050,1225,175,1,1,1
3336,LA 40082,"Brown Ware, Undifferentiated",2,500,1450,950,0,0,0
3336,LA 40082,Chaco-McElmo Black-on-white (carbon paint),7,1090,1175,85,1,1,1
3336,LA 40082,Chuska Black-on-white,2,1040,1125,85,1,1,1
3336,LA 40082,"Chuska Gray Ware, Type Undifferentiated",2,700,1300,600,0,0,0
3336,LA 40082,Chuska Indented Corrugated Gray,5,1040,1300,260,0,0,0
3336,LA 40082,"Chuska White Ware type, Undifferentiated",1,800,1300,500,0,1,1
3336,LA 40082,"Cibola BMIII/PI White Ware, Type Undifferentiated",1,550,900,350,0,1,1
3336,LA 40082,"Cibola Gray Ware, Undifferentiated",16,550,1400,850,0,0,0
3336,LA 40082,Cibola Indented Corrugated Gray,209,1040,1400,360,0,0,0
3336,LA 40082,Cibola Narrow Neckbanded,17,900,1025,125,0,1,0
3336,LA 40082,Cibola Neck Indented Corrugated,5,950,1025,75,0,1,0
3336,LA 40082,"Cibola PII Gray Ware, Type Undifferentiated",1,950,1100,150,0,1,0
3336,LA 40082,"Cibola PII/PIII Gray Ware, Type Undifferentiated",1,950,1300,350,0,0,0
3336,LA 40082,"Cibola PIII Gray Ware, Type Undifferentiated",1,1100,1300,200,0,1,0
3336,LA 40082,Cibola Plain Gray,103,550,1040,490,0,0,0
3336,LA 40082,Escavada Black-on-white,1,1000,1100,100,1,1,1
3336,LA 40082,Gallup Black-on-white,62,1040,1150,110,1,1,1
3336,LA 40082,Lino Gray (Cibola),8,550,950,400,1,0,0
3336,LA 40082,Mancos Black-on-white,1,980,1180,200,1,1,1
3336,LA 40082,McElmo Black-on-white,3,1060,1260,200,1,1,1
3336,LA 40082,"Mesa Verde White Ware, Undifferentiated",1,575,1280,705,0,1,1
3336,LA 40082,Newcomb Black-on-white,1,875,1000,125,1,1,1
3336,LA 40082,"PII/PIII White Ware, Type Undifferentiated",41,900,1300,400,0,1,1
3336,LA 40082,Puerco Black-on-white,37,1030,1200,170,1,1,1
3336,LA 40082,Red Mesa Black-on-white,15,880,1040,160,1,1,1
3336,LA 40082,Sanostee Black-on-red,1,825,875,50,1,1,1
3336,LA 40082,Tunicha Black-on-white,1,850,900,50,1,1,1
3336,LA 40082,"White ware, Undifferentiated",109,550,1900,1350,0,0,1
3336,LA 40082,Woodruff Smudged,1,500,1100,600,0,0,0
3340,Salt Point,Bluff Black-on-red,1,800,925,125,1,1,1
3340,Salt Point,"BMIII/PI White Ware, Type Undifferentiated",5,550,900,350,0,1,1
3340,Salt Point,"Cibola BMIII/PI White Ware, Type Undifferentiated",1,550,900,350,0,1,1
3340,Salt Point,Deadmans (La Plata) Black-on-red,1,880,1050,170,1,1,1
3340,Salt Point,Dinetah Gray,7,1500,1750,250,0,0,0
3340,Salt Point,Gobernador Polychrome,13,1650,1775,125,1,1,1
3340,Salt Point,"Plain Gray Ware, Undifferentiated",258,500,1300,800,0,0,0
3340,Salt Point,Rosa Black-on-white,6,700,875,175,1,1,1
3340,Salt Point,Rosa Brown,2,700,950,250,0,0,0
3340,Salt Point,Rosa Gray,36,700,1000,300,0,0,0
3340,Salt Point,Rosa Neckbanded,4,775,900,125,0,1,0
3343,Todie Flats,"Mesa Verde Gray ware, Undifferentiated",56,575,1280,705,0,0,0
3343,Todie Flats,"Mesa Verde White Ware, Undifferentiated",34,575,1280,705,0,1,1
3343,Todie Flats,"Red Ware type, Undifferentiated",13,700,1700,1000,0,0,0
3343,Todie Flats,"San Juan Red ware, Undifferentiated",4,700,1050,350,0,0,1
3343,Todie Flats,"Tsegi Orange Ware, Undifferentiated",9,1000,1300,300,1,0,1
3343,Todie Flats,"Tusayan Gray Ware, Undifferentiated",29,550,1285,735,0,0,0
3343,Todie Flats,"Tusayan White Ware, Undifferentiated",12,825,1300,475,0,1,1
3343,Todie Flats,"White ware, Undifferentiated",46,550,1900,1350,0,0,1
3344,Gravel Pit Ruin,Abajo Red-on-orange,5,760,880,120,1,1,1
3344,Gravel Pit Ruin,Bluff Black-on-red,19,800,925,125,1,1,1
3344,Gravel Pit Ruin,Chapin Gray,3,575,980,405,0,0,0
3344,Gravel Pit Ruin,Cortez Black-on-white,3,880,1060,180,1,1,1
3344,Gravel Pit Ruin,Deadmans (La Plata) Black-on-red,3,880,1050,170,1,1,1
3344,Gravel Pit Ruin,Mancos Corrugated,10,920,1180,260,0,0,0
3344,Gravel Pit Ruin,Mancos Gray,185,880,1060,180,0,1,0
3344,Gravel Pit Ruin,McElmo Black-on-white,1,1060,1260,200,1,1,1
3344,Gravel Pit Ruin,Mesa Verde Black-on-white,4,1180,1280,100,1,1,1
3344,Gravel Pit Ruin,"Mesa Verde Corrugated Gray Ware, Undifferentiated",439,920,1280,360,0,0,0
3344,Gravel Pit Ruin,"Mesa Verde PII/PIII White Ware, Type Undifferentiated",5,920,1280,360,0,1,1
3344,Gravel Pit Ruin,"Mesa Verde White Ware, Undifferentiated",7,575,1280,705,0,1,1
3344,Gravel Pit Ruin,Moccasin Gray,10,800,980,180,0,1,0
3344,Gravel Pit Ruin,Piedra Black-on-white,2,800,920,120,1,1,1
3344,Gravel Pit Ruin,"San Juan Red ware, Undifferentiated",16,700,1050,350,0,0,1
3344,Gravel Pit Ruin,White Mesa Black-on-white,21,850,1000,150,1,1,1
3345,NA 8044,"Black-on-red, Undifferentiated",1,700,1700,1000,0,1,1
3345,NA 8044,"Brown Ware, Undifferentiated",7,500,1450,950,0,0,0
3345,NA 8044,"Corrugated Gray Ware, Undifferentiated",5,800,1400,600,0,0,0
3345,NA 8044,Flagstaff Black-on-white,1,1150,1220,70,1,1,1
3345,NA 8044,Gallup Black-on-white,1,1040,1150,110,1,1,1
3345,NA 8044,"Gray Ware, Undifferentiated",4,400,1400,1000,0,0,0
3345,NA 8044,"Indented Corrugated Gray Ware, Undifferentiated",32,950,1400,450,0,0,0
3345,NA 8044,Kiatuthlanna Black-on-white,1,850,925,75,1,1,1
3345,NA 8044,Klagetoh Black-on-white,2,1250,1300,50,1,1,1
3345,NA 8044,Lino Gray (Tusayan),1,550,950,400,0,0,0
3345,NA 8044,"Mogollon Plain Brown Ware, Smudged",1,300,1400,1100,0,0,0
3345,NA 8044,"Plain Gray Ware, Undifferentiated",7,500,1300,800,0,0,0
3345,NA 8044,Puerco Black-on-red,3,1000,1175,175,1,1,1
3345,NA 8044,Puerco Black-on-white,11,1030,1200,170,1,1,1
3345,NA 8044,Red Mesa Black-on-white,1,880,1040,160,1,1,1
3345,NA 8044,"Red Ware type, Undifferentiated",5,700,1700,1000,0,0,0
3345,NA 8044,Showlow Black-on-red,45,1030,1200,170,1,1,1
3345,NA 8044,Walnut Black-on-white,1,1100,1250,150,1,1,1
3345,NA 8044,"White ware, Undifferentiated",4,550,1900,1350,0,0,1
3345,NA 8044,Wingate Black-on-red,1,1050,1225,175,1,1,1
3347,LA 103458,Chaco Black-on-white,6,1075,1150,75,1,1,1
3347,LA 103458,"Chuska Clapboard Corrugated Gray, Undifferentiated",1,900,1100,200,0,1,0
3347,LA 103458,Chuska Indented Corrugated Gray,7,1040,1300,260,0,0,0
3347,LA 103458,"Cibola Black-on-white, Undifferentiated",18,550,1325,775,0,1,1
3347,LA 103458,"Cibola Corrugated Gray Ware, Undifferentiated",43,900,1400,500,0,0,0
3347,LA 103458,Cibola Plain Gray,19,550,1040,490,0,0,0
3347,LA 103458,"Cibola White Ware, Undifferentiated",14,550,1325,775,0,1,1
3347,LA 103458,Escavada Black-on-white,2,1000,1100,100,1,1,1
3347,LA 103458,Gallup Black-on-white,7,1040,1150,110,1,1,1
3347,LA 103458,Puerco Black-on-white,3,1030,1200,170,1,1,1
3347,LA 103458,Red Mesa Black-on-white,6,880,1040,160,1,1,1
3347,LA 103458,"San Juan Red ware, Undifferentiated",2,700,1050,350,0,0,1
3347,LA 103458,Wingate Black-on-red,2,1050,1225,175,1,1,1
3348,LA 145983,"Chuska Plain Gray Ware, Type Undifferentiated",10,700,925,225,0,0,0
3348,LA 145983,"Cibola Black-on-white, Undifferentiated",20,550,1325,775,0,1,1
3348,LA 145983,Cibola Plain Gray,1644,550,1040,490,0,0,0
3348,LA 145983,"Cibola White Ware, Undifferentiated",4,550,1325,775,0,1,1
3348,LA 145983,La Plata Black-on-white,4,550,750,200,1,1,1
3348,LA 145983,La Plata-White Mound Black-on-white,9,550,850,300,1,1,1
3348,LA 145983,Lino Gray (Cibola),8,550,950,400,1,0,0
3348,LA 145983,Tallohogan Red,6,620,875,255,0,0,0
3348,LA 145983,"White Mountain type, Type Undifferentiated; Early",4,1000,1300,300,0,0,1
3349,LA 89443,Chuska Neckbanded,15,800,950,150,0,1,0
3349,LA 89443,"Chuska Plain Gray Ware, Type Undifferentiated",110,700,925,225,0,0,0
3349,LA 89443,"Chuska White Ware type, Undifferentiated",29,800,1300,500,0,1,1
3349,LA 89443,Cibola Neckbanded Gray,13,850,1025,175,0,1,0
3349,LA 89443,Cibola Plain Gray,177,550,1040,490,0,0,0
3349,LA 89443,"Cibola White Ware, Undifferentiated",46,550,1325,775,0,1,1
3349,LA 89443,La Plata Black-on-white,11,550,750,200,1,1,1
3349,LA 89443,Newcomb or Burnham Black-on-white,1,860,1000,140,1,1,1
3349,LA 89443,Red Mesa Black-on-white,15,880,1040,160,1,1,1
3349,LA 89443,"San Juan Red ware, Undifferentiated",3,700,1050,350,0,0,1
3349,LA 89443,Sanostee Black-on-red,1,825,875,50,1,1,1
3350,AZ-P-52-8-NN,"Cibola Black-on-white, Undifferentiated",2,550,1325,775,0,1,1
3350,AZ-P-52-8-NN,Escavada Black-on-white,4,1000,1100,100,1,1,1
3350,AZ-P-52-8-NN,Gallup Black-on-white,4,1040,1150,110,1,1,1
3350,AZ-P-52-8-NN,Holbrook Black-on-white,12,1050,1150,100,1,1,1
3350,AZ-P-52-8-NN,"Little Colorado Corrugated Gray Ware, Undifferentiated",30,1050,1250,200,0,1,0
3350,AZ-P-52-8-NN,"Little Colorado Plain Gray, Undifferentiated",6,550,1040,490,0,0,0
3350,AZ-P-52-8-NN,Padre Black-on-white,4,1100,1250,150,1,1,1
3350,AZ-P-52-8-NN,Puerco Black-on-red,18,1000,1175,175,1,1,1
3350,AZ-P-52-8-NN,Puerco Black-on-white,6,1030,1200,170,1,1,1
3350,AZ-P-52-8-NN,Sosi Black-on-white,2,1070,1180,110,1,1,1
3350,AZ-P-52-8-NN,St. Josephs Black-on-White,2,825,1050,225,1,1,1
3350,AZ-P-52-8-NN,Tularosa Black-on-white,6,1180,1300,120,1,1,1
3350,AZ-P-52-8-NN,"White Mountain type, Type Undifferentiated; Early",16,1000,1300,300,0,0,1
3350,AZ-P-52-8-NN,Wingate Black-on-red,2,1050,1225,175,1,1,1
3351,Cerritos de Jaspe GK,Cebolleta Black-on-white,25,1000,1200,200,1,1,1
3351,Cerritos de Jaspe GK,Cibola Indented Corrugated Gray,1,1040,1400,360,0,0,0
3351,Cerritos de Jaspe GK,Cibola Plain Gray,6,550,1040,490,0,0,0
3351,Cerritos de Jaspe GK,Mogollon Plain Brown Ware,7,300,1400,1100,0,0,0
3351,Cerritos de Jaspe GK,Puerco Black-on-red,1,1000,1175,175,1,1,1
3351,Cerritos de Jaspe GK,Socorro Black-on-white,21,1050,1300,250,1,1,1
3351,Cerritos de Jaspe GK,"White Mountain type, Type Undifferentiated; Early",2,1000,1300,300,0,0,1
3351,Cerritos de Jaspe GK,"White ware, Undifferentiated",17,550,1900,1350,0,0,1
3353,Andrews Great Kiva NM,"Cibola Gray Ware, Undifferentiated",2,550,1400,850,0,0,0
3353,Andrews Great Kiva NM,Cibola Narrow Neckbanded,2,900,1025,125,0,1,0
3353,Andrews Great Kiva NM,Cibola Neckbanded Gray,6,850,1025,175,0,1,0
3353,Andrews Great Kiva NM,"Cibola PII White Ware, Type Undifferentiated",11,880,1100,220,1,1,1
3353,Andrews Great Kiva NM,Cibola Plain Gray,54,550,1040,490,0,0,0
3353,Andrews Great Kiva NM,"Cibola White Ware, Undifferentiated",9,550,1325,775,0,1,1
3353,Andrews Great Kiva NM,Cibola Wide Neckbanded,4,850,925,75,0,1,0
3353,Andrews Great Kiva NM,"Corrugated Gray Ware, Undifferentiated",1,800,1400,600,0,0,0
3353,Andrews Great Kiva NM,Escavada Black-on-white,3,1000,1100,100,1,1,1
3353,Andrews Great Kiva NM,Gallup Black-on-white,1,1040,1150,110,1,1,1
3353,Andrews Great Kiva NM,Kiatuthlanna Black-on-white,11,850,925,75,1,1,1
3353,Andrews Great Kiva NM,"Plain Gray Ware, Undifferentiated",137,500,1300,800,0,0,0
3353,Andrews Great Kiva NM,Puerco Black-on-white,1,1030,1200,170,1,1,1
3353,Andrews Great Kiva NM,Red Mesa Black-on-white,44,880,1040,160,1,1,1
3353,Andrews Great Kiva NM,"San Juan Red ware, Undifferentiated",1,700,1050,350,0,0,1
3353,Andrews Great Kiva NM,"White ware, Undifferentiated",32,550,1900,1350,0,0,1
3355,HST Great Kiva,Black Mesa Black-on-white,4,1000,1100,100,1,1,1
3355,HST Great Kiva,Cameron Polychrome,1,1040,1170,130,1,1,1
3355,HST Great Kiva,Citadel Polychrome,2,1040,1200,160,1,1,1
3355,HST Great Kiva,Dogoszhi Black-on-white,3,1040,1210,170,1,1,1
3355,HST Great Kiva,Mancos Black-on-white,120,980,1180,200,1,1,1
3355,HST Great Kiva,"Mesa Verde Corrugated Gray Ware, Undifferentiated",154,920,1280,360,0,0,0
3355,HST Great Kiva,"Orange Ware, Undifferentiated",1,1000,1350,350,0,0,0
3355,HST Great Kiva,Sosi Black-on-white,12,1070,1180,110,1,1,1
3355,HST Great Kiva,"Tsegi Orange Ware, Undifferentiated",27,1000,1300,300,1,0,1
3355,HST Great Kiva,Tusayan Black-on-red,14,1045,1240,195,1,1,1
3355,HST Great Kiva,"White ware, Undifferentiated",28,550,1900,1350,0,0,1
3356,Sand Canyon Pueblo,Abajo Red-on-orange,2,760,880,120,1,1,1
3356,Sand Canyon Pueblo,Bluff Black-on-red,7,800,925,125,1,1,1
3356,Sand Canyon Pueblo,Chapin Black-on-white,9,575,880,305,0,1,1
3356,Sand Canyon Pueblo,Chapin Gray,6,575,980,405,0,0,0
3356,Sand Canyon Pueblo,Cortez Black-on-white,5,880,1060,180,1,1,1
3356,Sand Canyon Pueblo,Deadmans (La Plata) Black-on-red,2,880,1050,170,1,1,1
3356,Sand Canyon Pueblo,Mancos Black-on-white,41,980,1180,200,1,1,1
3356,Sand Canyon Pueblo,Mancos Corrugated,136,920,1180,260,0,0,0
3356,Sand Canyon Pueblo,Mancos Gray,4,880,1060,180,0,1,0
3356,Sand Canyon Pueblo,McElmo Black-on-white,208,1060,1260,200,1,1,1
3356,Sand Canyon Pueblo,Mesa Verde Black-on-white,2753,1180,1280,100,1,1,1
3356,Sand Canyon Pueblo,"Mesa Verde BMIII/PI White Ware, Type Undifferentiated",35,575,920,345,0,1,1
3356,Sand Canyon Pueblo,Mesa Verde Corrugated,1557,1100,1280,180,0,1,0
3356,Sand Canyon Pueblo,"Mesa Verde Corrugated Gray Ware, Undifferentiated",78261,920,1280,360,0,0,0
3356,Sand Canyon Pueblo,"Mesa Verde Gray ware, Undifferentiated",899,575,1280,705,0,0,0
3356,Sand Canyon Pueblo,"Mesa Verde PII White Ware, Type Undifferentiated",36,920,1100,180,1,1,1
3356,Sand Canyon Pueblo,"Mesa Verde PII/PIII White Ware, Type Undifferentiated",31263,920,1280,360,0,1,1
3356,Sand Canyon Pueblo,"Mesa Verde PIII White Ware, Type Undifferentiated",9175,1100,1280,180,1,1,1
3356,Sand Canyon Pueblo,"Mesa Verde White Ware, Undifferentiated",52,575,1280,705,0,1,1
3356,Sand Canyon Pueblo,Mummy Lake Gray,2,1150,1280,130,0,1,0
3356,Sand Canyon Pueblo,"Plain Gray Ware, Undifferentiated",26,500,1300,800,0,0,0
3356,Sand Canyon Pueblo,"Polychrome, Undifferentiated",72,700,1900,1200,0,1,1
3356,Sand Canyon Pueblo,"Red Ware type, Undifferentiated",9,700,1700,1000,0,0,0
3356,Sand Canyon Pueblo,"San Juan Red ware, Undifferentiated",23,700,1050,350,0,0,1
3356,Sand Canyon Pueblo,Sosi Black-on-white,1,1070,1180,110,1,1,1
3356,Sand Canyon Pueblo,"Tsegi Orange Ware, Undifferentiated",8,1000,1300,300,1,0,1
3356,Sand Canyon Pueblo,Tusayan Black-on-red,1,1045,1240,195,1,1,1
3356,Sand Canyon Pueblo,Tusayan Polychrome,3,1110,1320,210,1,1,1
3356,Sand Canyon Pueblo,"Tusayan White Ware, Undifferentiated",1,825,1300,475,0,1,1
3356,Sand Canyon Pueblo,"Type, Undifferentiated",34,200,1900,1700,0,0,0
3356,Sand Canyon Pueblo,"White ware, Undifferentiated",2,550,1900,1350,0,0,1
3356,Sand Canyon Pueblo,Wingate Black-on-red,2,1050,1225,175,1,1,1
3358,Woods Canyon Pueblo,Chapin Black-on-white,1,575,880,305,0,1,1
3358,Woods Canyon Pueblo,Chapin Gray,1,575,980,405,0,0,0
3358,Woods Canyon Pueblo,Cortez Black-on-white,1,880,1060,180,1,1,1
3358,Woods Canyon Pueblo,Mancos Black-on-white,144,980,1180,200,1,1,1
3358,Woods Canyon Pueblo,Mancos Corrugated,32,920,1180,260,0,0,0
3358,Woods Canyon Pueblo,Mancos Gray,1,880,1060,180,0,1,0
3358,Woods Canyon Pueblo,McElmo Black-on-white,204,1060,1260,200,1,1,1
3358,Woods Canyon Pueblo,Mesa Verde Black-on-white,240,1180,1280,100,1,1,1
3358,Woods Canyon Pueblo,"Mesa Verde BMIII/PI White Ware, Type Undifferentiated",6,575,920,345,0,1,1
3358,Woods Canyon Pueblo,Mesa Verde Corrugated,143,1100,1280,180,0,1,0
3358,Woods Canyon Pueblo,"Mesa Verde Corrugated Gray Ware, Undifferentiated",12850,920,1280,360,0,0,0
3358,Woods Canyon Pueblo,"Mesa Verde Gray ware, Undifferentiated",446,575,1280,705,0,0,0
3358,Woods Canyon Pueblo,"Mesa Verde PII White Ware, Type Undifferentiated",4,920,1100,180,1,1,1
3358,Woods Canyon Pueblo,"Mesa Verde PII/PIII White Ware, Type Undifferentiated",6217,920,1280,360,0,1,1
3358,Woods Canyon Pueblo,"Mesa Verde PIII White Ware, Type Undifferentiated",2156,1100,1280,180,1,1,1
3358,Woods Canyon Pueblo,"Mesa Verde White Ware, Undifferentiated",8,575,1280,705,0,1,1
3358,Woods Canyon Pueblo,Moccasin Gray,5,800,980,180,0,1,0
3358,Woods Canyon Pueblo,"Plain Gray Ware, Undifferentiated",9,500,1300,800,0,0,0
3358,Woods Canyon Pueblo,"Polychrome, Undifferentiated",1,700,1900,1200,0,1,1
3358,Woods Canyon Pueblo,"Red Ware type, Undifferentiated",3,700,1700,1000,0,0,0
3358,Woods Canyon Pueblo,"Type, Undifferentiated",31,200,1900,1700,0,0,0
3358,Woods Canyon Pueblo,"White ware, Undifferentiated",1,550,1900,1350,0,0,1
3359,Seven Towers,Mancos Black-on-white,5,980,1180,200,1,1,1
3359,Seven Towers,Mancos Corrugated,3,920,1180,260,0,0,0
3359,Seven Towers,McElmo Black-on-white,22,1060,1260,200,1,1,1
3359,Seven Towers,Mesa Verde Black-on-white,33,1180,1280,100,1,1,1
3359,Seven Towers,Mesa Verde Corrugated,10,1100,1280,180,0,1,0
3359,Seven Towers,"Mesa Verde Corrugated Gray Ware, Undifferentiated",84,920,1280,360,0,0,0
3359,Seven Towers,"Mesa Verde PII/PIII White Ware, Type Undifferentiated",80,920,1280,360,0,1,1
3359,Seven Towers,"Mesa Verde PIII White Ware, Type Undifferentiated",80,1100,1280,180,1,1,1
3360,Bass Complex,Cortez Black-on-white,2,880,1060,180,1,1,1
3360,Bass Complex,Mancos Black-on-white,194,980,1180,200,1,1,1
3360,Bass Complex,Mancos Corrugated,8,920,1180,260,0,0,0
3360,Bass Complex,McElmo Black-on-white,44,1060,1260,200,1,1,1
3360,Bass Complex,Mesa Verde Black-on-white,61,1180,1280,100,1,1,1
3360,Bass Complex,"Mesa Verde BMIII/PI White Ware, Type Undifferentiated",14,575,920,345,0,1,1
3360,Bass Complex,Mesa Verde Corrugated,20,1100,1280,180,0,1,0
3360,Bass Complex,"Mesa Verde Corrugated Gray Ware, Undifferentiated",521,920,1280,360,0,0,0
3360,Bass Complex,"Mesa Verde Gray ware, Undifferentiated",35,575,1280,705,0,0,0
3360,Bass Complex,"Mesa Verde PII White Ware, Type Undifferentiated",16,920,1100,180,1,1,1
3360,Bass Complex,"Mesa Verde PII/PIII White Ware, Type Undifferentiated",303,920,1280,360,0,1,1
3360,Bass Complex,"Mesa Verde PIII White Ware, Type Undifferentiated",196,1100,1280,180,1,1,1
3360,Bass Complex,"Mesa Verde White Ware, Undifferentiated",3,575,1280,705,0,1,1
3360,Bass Complex,Piedra Black-on-white,1,800,920,120,1,1,1
3360,Bass Complex,"San Juan Red ware, Undifferentiated",3,700,1050,350,0,0,1
3361,Rich's Ruin,Mancos Black-on-white,18,980,1180,200,1,1,1
3361,Rich's Ruin,McElmo Black-on-white,4,1060,1260,200,1,1,1
3361,Rich's Ruin,Mesa Verde Black-on-white,2,1180,1280,100,1,1,1
3361,Rich's Ruin,Mesa Verde Corrugated,4,1100,1280,180,0,1,0
3361,Rich's Ruin,"Mesa Verde Corrugated Gray Ware, Undifferentiated",288,920,1280,360,0,0,0
3361,Rich's Ruin,"Mesa Verde Gray ware, Undifferentiated",8,575,1280,705,0,0,0
3361,Rich's Ruin,"Mesa Verde PII/PIII White Ware, Type Undifferentiated",135,920,1280,360,0,1,1
3361,Rich's Ruin,"Mesa Verde PIII White Ware, Type Undifferentiated",35,1100,1280,180,1,1,1
3363,Kin Bineola Great Kiva 2,Chuska Indented Corrugated Gray,2,1040,1300,260,0,0,0
3363,Kin Bineola Great Kiva 2,"Chuska Plain Gray Ware, Type Undifferentiated",6,700,925,225,0,0,0
3363,Kin Bineola Great Kiva 2,"Cibola Black-on-white, Undifferentiated",32,550,1325,775,0,1,1
3363,Kin Bineola Great Kiva 2,Cibola Indented Corrugated Gray,10,1040,1400,360,0,0,0
3363,Kin Bineola Great Kiva 2,Cibola Neckbanded Gray,5,850,1025,175,0,1,0
3363,Kin Bineola Great Kiva 2,Cibola Plain Gray,37,550,1040,490,0,0,0
3363,Kin Bineola Great Kiva 2,Escavada-Puerco Black-on-white,8,1000,1100,100,1,1,1
3363,Kin Bineola Great Kiva 2,Gallup Black-on-white,4,1040,1150,110,1,1,1
3363,Kin Bineola Great Kiva 2,Red Mesa Black-on-white,31,880,1040,160,1,1,1
3363,Kin Bineola Great Kiva 2,"San Juan Red ware, Undifferentiated",3,700,1050,350,0,0,1
3363,Kin Bineola Great Kiva 2,Sanostee Black-on-red,1,825,875,50,1,1,1
3363,Kin Bineola Great Kiva 2,White Mound Black-on-white,1,700,850,150,1,1,1
3364,Mud Springs--Northern San Juan,Cortez Black-on-white,1,880,1060,180,1,1,1
3364,Mud Springs--Northern San Juan,Mancos Black-on-white,3,980,1180,200,1,1,1
3364,Mud Springs--Northern San Juan,McElmo Black-on-white,4,1060,1260,200,1,1,1
3364,Mud Springs--Northern San Juan,Mesa Verde Black-on-white,6,1180,1280,100,1,1,1
3364,Mud Springs--Northern San Juan,Mesa Verde Plain Gray,1,575,1020,445,0,0,0
3366,Haystack Great Kiva 2,Cibola Indented Corrugated Gray,9,1040,1400,360,0,0,0
3366,Haystack Great Kiva 2,Cibola Neckbanded Gray,21,850,1025,175,0,1,0
3366,Haystack Great Kiva 2,Cibola Plain Gray,86,550,1040,490,0,0,0
3366,Haystack Great Kiva 2,Escavada-Puerco Black-on-white,3,1000,1100,100,1,1,1
3366,Haystack Great Kiva 2,Gallup Black-on-white,5,1040,1150,110,1,1,1
3366,Haystack Great Kiva 2,Kana-a Black-on-white,1,825,1000,175,1,1,1
3366,Haystack Great Kiva 2,Red Mesa Black-on-white,21,880,1040,160,1,1,1
3367,NA 8013,Alma Series type,6,300,1000,700,0,0,0
3367,NA 8013,Black Mesa Black-on-white,53,1000,1100,100,1,1,1
3367,NA 8013,"Black-on-red, Undifferentiated",22,700,1700,1000,0,1,1
3367,NA 8013,Bluff Black-on-red,1,800,925,125,1,1,1
3367,NA 8013,"BMIII/PI White Ware, Type Undifferentiated",11,550,900,350,0,1,1
3367,NA 8013,"Brown Ware, Undifferentiated",8,500,1450,950,0,0,0
3367,NA 8013,Cibola Narrow Neckbanded,602,900,1025,125,0,1,0
3367,NA 8013,"Cibola White Ware, Undifferentiated",536,550,1325,775,0,1,1
3367,NA 8013,"Corrugated Gray Ware, Undifferentiated",942,800,1400,600,0,0,0
3367,NA 8013,Gallup Black-on-white,383,1040,1150,110,1,1,1
3367,NA 8013,"Gray Ware, Undifferentiated",7,400,1400,1000,0,0,0
3367,NA 8013,Holbrook Black-on-white,6,1050,1150,100,1,1,1
3367,NA 8013,"Indented Corrugated Gray Ware, Undifferentiated",521,950,1400,450,0,0,0
3367,NA 8013,Kana-a Black-on-white,239,825,1000,175,1,1,1
3367,NA 8013,Kana'a Gray Ware,3463,865,1060,195,0,1,0
3367,NA 8013,Kana'a Neckbanded,167,865,1060,195,0,1,0
3367,NA 8013,Kiatuthlanna Black-on-white,347,850,925,75,1,1,1
3367,NA 8013,Kiatuthlanna-Red Mesa Black-on-white,72,850,1040,190,1,1,1
3367,NA 8013,La Plata Black-on-white,2,550,750,200,1,1,1
3367,NA 8013,Lino Gray (Cibola),39,550,950,400,1,0,0
3367,NA 8013,Lino Gray Fugitive Red [Cibola Series],11,550,850,300,1,0,0
3367,NA 8013,McElmo Black-on-white,4,1060,1260,200,1,1,1
3367,NA 8013,"Mogollon Plain Brown Ware, Smudged",70,300,1400,1100,0,0,0
3367,NA 8013,"Narrow Neckbanded Gray Ware, Type Undifferentiated",225,900,1025,125,0,1,0
3367,NA 8013,"Neckbanded Gray Ware, Undifferentiated",7,850,1025,175,0,1,0
3367,NA 8013,"Obliterated Corrugated Gray Ware, Undifferentiated",9,1100,1400,300,0,0,0
3367,NA 8013,"PII/PIII White Ware, Type Undifferentiated",87,900,1300,400,0,1,1
3367,NA 8013,Pinedale Black-on-red,1,1280,1330,50,1,1,1
3367,NA 8013,"Plain Gray Ware, Undifferentiated",1075,500,1300,800,0,0,0
3367,NA 8013,Puerco Black-on-red,15,1000,1175,175,1,1,1
3367,NA 8013,Puerco Black-on-white,232,1030,1200,170,1,1,1
3367,NA 8013,Puerco or Red Mesa Black-on-white,134,880,1200,320,0,0,1
3367,NA 8013,Red Mesa Black-on-white,559,880,1040,160,1,1,1
3367,NA 8013,"Red Ware type, Undifferentiated",10,700,1700,1000,0,0,0
3367,NA 8013,Sosi Black-on-white,4,1070,1180,110,1,1,1
3367,NA 8013,St. Johns Black-on-red,3,1200,1300,100,1,1,1
3367,NA 8013,St. Johns Black-on-red or Polychrome,3,1200,1300,100,1,1,1
3367,NA 8013,St. Johns Polychrome,5,1200,1300,100,1,1,1
3367,NA 8013,Tusayan Polychrome,2,1110,1320,210,1,1,1
3367,NA 8013,"Type, Undifferentiated",1,200,1900,1700,0,0,0
3367,NA 8013,Walnut Black-on-white,7,1100,1250,150,1,1,1
3367,NA 8013,White Mound Black-on-white,83,700,850,150,1,1,1
3367,NA 8013,"White Mountain type, Type Undifferentiated; Early",2,1000,1300,300,0,0,1
3367,NA 8013,"White ware, Undifferentiated",500,550,1900,1350,0,0,1
3367,NA 8013,"Wide Neckbanded Gray Ware, Type Undifferentiated",39,850,925,75,0,1,0
3367,NA 8013,Wingate Black-on-red,2,1050,1225,175,1,1,1
3367,NA 8013,Woodruff Smudged,21,500,1100,600,0,0,0
3368,NA 8014,Black Mesa Black-on-white,11,1000,1100,100,1,1,1
3368,NA 8014,"Black-on-red, Undifferentiated",1,700,1700,1000,0,1,1
3368,NA 8014,"Cibola White Ware, Undifferentiated",67,550,1325,775,0,1,1
3368,NA 8014,"Corrugated Gray Ware, Undifferentiated",30,800,1400,600,0,0,0
3368,NA 8014,Gallup Black-on-white,14,1040,1150,110,1,1,1
3368,NA 8014,"Indented Corrugated Gray Ware, Undifferentiated",44,950,1400,450,0,0,0
3368,NA 8014,Kana-a Black-on-white,25,825,1000,175,1,1,1
3368,NA 8014,Kana'a Gray Ware,467,865,1060,195,0,1,0
3368,NA 8014,Kana'a Neckbanded,7,865,1060,195,0,1,0
3368,NA 8014,Kiatuthlanna Black-on-white,31,850,925,75,1,1,1
3368,NA 8014,La Plata Black-on-white,1,550,750,200,1,1,1
3368,NA 8014,Medicine Black-on-red,1,1040,1170,130,1,1,1
3368,NA 8014,Mogollon Plain Brown Ware,2,300,1400,1100,0,0,0
3368,NA 8014,"Mogollon Plain Brown Ware, Smudged",2,300,1400,1100,0,0,0
3368,NA 8014,"Neck Indented Corrugated Gray Ware, Type Undifferentiated",1,950,1025,75,0,1,0
3368,NA 8014,"Neckbanded Gray Ware, Undifferentiated",141,850,1025,175,0,1,0
3368,NA 8014,Puerco Black-on-white,14,1030,1200,170,1,1,1
3368,NA 8014,Red Mesa Black-on-white,34,880,1040,160,1,1,1
3368,NA 8014,"Red Ware type, Undifferentiated",2,700,1700,1000,0,0,0
3368,NA 8014,"Type, Undifferentiated",1,200,1900,1700,0,0,0
3368,NA 8014,White Mound Black-on-white,2,700,850,150,1,1,1
3368,NA 8014,"White ware, Undifferentiated",394,550,1900,1350,0,0,1
3369,Prater Village,Deadmans (La Plata) Black-on-red,1,880,1050,170,1,1,1
3369,Prater Village,Mancos Black-on-white,22,980,1180,200,1,1,1
3369,Prater Village,Mancos Corrugated,10,920,1180,260,0,0,0
3369,Prater Village,Mancos Gray,7,880,1060,180,0,1,0
3369,Prater Village,Mesa Verde Black-on-white,1,1180,1280,100,1,1,1
3369,Prater Village,"Mesa Verde Corrugated Gray Ware, Undifferentiated",56,920,1280,360,0,0,0
3369,Prater Village,Moccasin Gray,3,800,980,180,0,1,0
3369,Prater Village,"White ware, Undifferentiated",90,550,1900,1350,0,0,1
3370,Whites Canyon Pueblo,Cortez Black-on-white,28,880,1060,180,1,1,1
3370,Whites Canyon Pueblo,Dolores Corrugated,4,1100,1200,100,0,1,0
3370,Whites Canyon Pueblo,Mancos Black-on-white,53,980,1180,200,1,1,1
3370,Whites Canyon Pueblo,Mancos Corrugated,14,920,1180,260,0,0,0
3370,Whites Canyon Pueblo,Mancos Gray,4,880,1060,180,0,1,0
3370,Whites Canyon Pueblo,McElmo Black-on-white,1,1060,1260,200,1,1,1
3370,Whites Canyon Pueblo,"Mesa Verde BMIII/PI White Ware, Type Undifferentiated",1,575,920,345,0,1,1
3370,Whites Canyon Pueblo,"Mesa Verde Corrugated Gray Ware, Undifferentiated",318,920,1280,360,0,0,0
3370,Whites Canyon Pueblo,"Mesa Verde PII White Ware, Type Undifferentiated",34,920,1100,180,1,1,1
3370,Whites Canyon Pueblo,"Mesa Verde PII/PIII White Ware, Type Undifferentiated",191,920,1280,360,0,1,1
3370,Whites Canyon Pueblo,Mesa Verde Plain Gray,7,575,1020,445,0,0,0
3370,Whites Canyon Pueblo,Piedra Black-on-white,2,800,920,120,1,1,1
3370,Whites Canyon Pueblo,"PII/PIII White Ware, Type Undifferentiated",5,900,1300,400,0,1,1
3370,Whites Canyon Pueblo,"San Juan Red ware, Undifferentiated",1,700,1050,350,0,0,1
3370,Whites Canyon Pueblo,Wetherill Black-on-white,19,1060,1180,120,1,1,1
3371,34-plex Complex,Cortez Black-on-white,1,880,1060,180,1,1,1
3371,34-plex Complex,Mancos Black-on-white,33,980,1180,200,1,1,1
3371,34-plex Complex,Mancos Corrugated,7,920,1180,260,0,0,0
3371,34-plex Complex,Mancos Gray,5,880,1060,180,0,1,0
3371,34-plex Complex,McElmo Black-on-white,5,1060,1260,200,1,1,1
3371,34-plex Complex,Mesa Verde Black-on-white,12,1180,1280,100,1,1,1
3371,34-plex Complex,Mesa Verde Corrugated,7,1100,1280,180,0,1,0
3371,34-plex Complex,"Mesa Verde Corrugated Gray Ware, Undifferentiated",496,920,1280,360,0,0,0
3371,34-plex Complex,"Mesa Verde PI/PII White Ware, Type Undifferentiated",7,750,1180,430,0,1,1
3371,34-plex Complex,"Mesa Verde PII White Ware, Type Undifferentiated",7,920,1100,180,1,1,1
3371,34-plex Complex,"Mesa Verde PII/PIII White Ware, Type Undifferentiated",254,920,1280,360,0,1,1
3371,34-plex Complex,"Mesa Verde PIII White Ware, Type Undifferentiated",50,1100,1280,180,1,1,1
3371,34-plex Complex,Mesa Verde Plain Gray,3,575,1020,445,0,0,0
3371,34-plex Complex,"San Juan Red ware, Undifferentiated",3,700,1050,350,0,0,1
3372,Sacred Ridge,Abajo Red-on-orange,24,760,880,120,1,1,1
3372,Sacred Ridge,Arboles Gray,106,900,1050,150,0,1,0
3372,Sacred Ridge,Bluff Black-on-red,35,800,925,125,1,1,1
3372,Sacred Ridge,"BMIII/PI White Ware, Type Undifferentiated",1649,550,900,350,0,1,1
3372,Sacred Ridge,"Brown Ware, Undifferentiated",29,500,1450,950,0,0,0
3372,Sacred Ridge,Chapin Black-on-white,15,575,880,305,0,1,1
3372,Sacred Ridge,Moccasin Gray,7,800,980,180,0,1,0
3372,Sacred Ridge,"Mudware, Undifferentiated",5,400,1400,1000,0,0,0
3372,Sacred Ridge,"Neckbanded Gray Ware, Undifferentiated",20,850,1025,175,0,1,0
3372,Sacred Ridge,Rosa Black-on-white,635,700,875,175,1,1,1
3372,Sacred Ridge,Rosa Gray,771,700,1000,300,0,0,0
3372,Sacred Ridge,Rosa Neckbanded,9,775,900,125,0,1,0
3372,Sacred Ridge,"San Juan Red ware, Undifferentiated",81,700,1050,350,0,0,1
3372,Sacred Ridge,Upper San Juan PI Gray Ware,15311,700,900,200,0,1,0
3387,Upper Battleship Rock Pueblo,Chapin Gray,2,575,980,405,0,0,0
3387,Upper Battleship Rock Pueblo,Cortez Black-on-white,19,880,1060,180,1,1,1
3387,Upper Battleship Rock Pueblo,Deadmans (La Plata) Black-on-red,2,880,1050,170,1,1,1
3387,Upper Battleship Rock Pueblo,Dolores Corrugated,3,1100,1200,100,0,1,0
3387,Upper Battleship Rock Pueblo,Mancos Black-on-white,74,980,1180,200,1,1,1
3387,Upper Battleship Rock Pueblo,Mancos Corrugated,7,920,1180,260,0,0,0
3387,Upper Battleship Rock Pueblo,Mancos Gray,6,880,1060,180,0,1,0
3387,Upper Battleship Rock Pueblo,McElmo Black-on-white,17,1060,1260,200,1,1,1
3387,Upper Battleship Rock Pueblo,Mesa Verde Black-on-white,18,1180,1280,100,1,1,1
3387,Upper Battleship Rock Pueblo,Mesa Verde Corrugated,4,1100,1280,180,0,1,0
3387,Upper Battleship Rock Pueblo,"Mesa Verde Corrugated Gray Ware, Undifferentiated",376,920,1280,360,0,0,0
3387,Upper Battleship Rock Pueblo,Mesa Verde Neckbanded Gray,5,800,1060,260,0,0,0
3387,Upper Battleship Rock Pueblo,"Mesa Verde PII White Ware, Type Undifferentiated",39,920,1100,180,1,1,1
3387,Upper Battleship Rock Pueblo,"Mesa Verde PII/PIII White Ware, Type Undifferentiated",237,920,1280,360,0,1,1
3387,Upper Battleship Rock Pueblo,"Mesa Verde PIII White Ware, Type Undifferentiated",22,1100,1280,180,1,1,1
3387,Upper Battleship Rock Pueblo,Mesa Verde Plain Gray,53,575,1020,445,0,0,0
3387,Upper Battleship Rock Pueblo,Mummy Lake Gray,1,1150,1280,130,0,1,0
3387,Upper Battleship Rock Pueblo,Piedra Black-on-white,1,800,920,120,1,1,1
3387,Upper Battleship Rock Pueblo,"San Juan Red ware, Undifferentiated",1,700,1050,350,0,0,1
3387,Upper Battleship Rock Pueblo,Wetherill Black-on-white,11,1060,1180,120,1,1,1
3396,Farmer Complex,Chaco-McElmo Black-on-white (carbon paint),2,1090,1175,85,1,1,1
3396,Farmer Complex,"Corrugated Gray Ware, Undifferentiated",7,800,1400,600,0,0,0
3396,Farmer Complex,"Indented Corrugated Gray Ware, Undifferentiated",100,950,1400,450,0,0,0
3396,Farmer Complex,Mancos Black-on-white,3,980,1180,200,1,1,1
3396,Farmer Complex,McCartys Polychrome,2,1850,1875,25,1,1,1
3396,Farmer Complex,McElmo Black-on-white,11,1060,1260,200,1,1,1
3396,Farmer Complex,"PII Gray Rim, Type Undifferentiated",1,900,1100,200,0,1,0
3396,Farmer Complex,"PII/PIII Gray Rim, Type Undifferentiated",2,900,1300,400,0,0,0
3396,Farmer Complex,"PII/PIII White Ware, Type Undifferentiated",1,900,1300,400,0,1,1
3396,Farmer Complex,"Plain Gray Ware, Undifferentiated",10,500,1300,800,0,0,0
3396,Farmer Complex,"Tsegi Orange Ware, Undifferentiated",2,1000,1300,300,1,0,1
3396,Farmer Complex,"White Mountain type, Type Undifferentiated; Early",1,1000,1300,300,0,0,1
3396,Farmer Complex,"White ware, Undifferentiated",26,550,1900,1350,0,0,1
3396,Farmer Complex,Woodruff Smudged,1,500,1100,600,0,0,0
3399,Aztec North,Chaco Black-on-white,1,1075,1150,75,1,1,1
3399,Aztec North,Chaco-McElmo Black-on-white (carbon paint),4,1090,1175,85,1,1,1
3399,Aztec North,Chuska Black-on-white,2,1040,1125,85,1,1,1
3399,Aztec North,Chuska Indented Corrugated Gray,25,1040,1300,260,0,0,0
3399,Aztec North,Chuska Neck Indented Corrugated Gray,2,950,1025,75,0,1,0
3399,Aztec North,"Chuska PII/PIII Black-on-white, Type Undifferentiated",2,900,1300,400,0,1,1
3399,Aztec North,Cibola Indented Corrugated Gray,11,1040,1400,360,0,0,0
3399,Aztec North,Cibola Neck Indented Corrugated,1,950,1025,75,0,1,0
3399,Aztec North,"Cibola PII/PIII Gray Ware, Type Undifferentiated",1,950,1300,350,0,0,0
3399,Aztec North,"Corrugated Gray Ware, Undifferentiated",164,800,1400,600,0,0,0
3399,Aztec North,Escavada-Puerco Black-on-white,3,1000,1100,100,1,1,1
3399,Aztec North,Gallup Black-on-white,9,1040,1150,110,1,1,1
3399,Aztec North,Mancos Black-on-white,17,980,1180,200,1,1,1
3399,Aztec North,McElmo Black-on-white,12,1060,1260,200,1,1,1
3399,Aztec North,Mesa Verde Corrugated,48,1100,1280,180,0,1,0
3399,Aztec North,"Mesa Verde Gray ware, Undifferentiated",1,575,1280,705,0,0,0
3399,Aztec North,Mesa Verde Neck Corrugated Gray,5,950,1025,75,0,1,0
3399,Aztec North,"Mesa Verde PII/PIII White Ware, Type Undifferentiated",6,920,1280,360,0,1,1
3399,Aztec North,Mesa Verde Plain Gray,12,575,1020,445,0,0,0
3399,Aztec North,"Neck Indented Corrugated Gray Ware, Type Undifferentiated",6,950,1025,75,0,1,0
3399,Aztec North,"PII White Ware, Type Undifferentiated",1,900,1100,200,1,1,1
3399,Aztec North,"PII/PIII Gray Rim, Type Undifferentiated",2,900,1300,400,0,0,0
3399,Aztec North,"PII/PIII White Ware, Type Undifferentiated",23,900,1300,400,0,1,1
3399,Aztec North,"Plain Gray Ware, Undifferentiated",79,500,1300,800,0,0,0
3399,Aztec North,Puerco Black-on-red,1,1000,1175,175,1,1,1
3399,Aztec North,"Red Ware type, Undifferentiated",1,700,1700,1000,0,0,0
3399,Aztec North,Sosi Black-on-white,1,1070,1180,110,1,1,1
3399,Aztec North,Toadlena Black-on-white,5,975,1125,150,1,1,1
3399,Aztec North,"Tsegi Orange Ware, Undifferentiated",3,1000,1300,300,1,0,1
3399,Aztec North,Tusayan Polychrome,1,1110,1320,210,1,1,1
3399,Aztec North,"White ware, Undifferentiated",80,550,1900,1350,0,0,1
3401,Gillentine Site,Brimhall Black-on-white,1,1040,1150,110,1,1,1
3401,Gillentine Site,Chaco Black-on-white,1,1075,1150,75,1,1,1
3401,Gillentine Site,Chaco-McElmo Black-on-white (carbon paint),1,1090,1175,85,1,1,1
3401,Gillentine Site,Gallup Black-on-white,1,1040,1150,110,1,1,1
3401,Gillentine Site,"Gray Ware, Undifferentiated",127,400,1400,1000,0,0,0
3401,Gillentine Site,Mancos Black-on-white,11,980,1180,200,1,1,1
3401,Gillentine Site,McElmo Black-on-white,4,1060,1260,200,1,1,1
3401,Gillentine Site,"PIII White Ware, Type Undifferentiated",1,1100,1300,200,1,1,1
3401,Gillentine Site,Red Mesa Black-on-white,1,880,1040,160,1,1,1
3401,Gillentine Site,"White Mountain type, Type Undifferentiated; Early",1,1000,1300,300,0,0,1
3401,Gillentine Site,"White ware, Undifferentiated",41,550,1900,1350,0,0,1
3403,San Juan Biwall,Abajo Polychrome,3,850,925,75,1,1,1
3403,San Juan Biwall,Abajo Red-on-orange,7,760,880,120,1,1,1
3403,San Juan Biwall,Chapin Black-on-white,16,575,880,305,0,1,1
3403,San Juan Biwall,Chapin Gray,26,575,980,405,0,0,0
3403,San Juan Biwall,Chapin Gray Fugitive Red,1,575,980,405,0,0,0
3403,San Juan Biwall,Deadmans (La Plata) Black-on-red,1,880,1050,170,1,1,1
3403,San Juan Biwall,Mancos Black-on-white,10,980,1180,200,1,1,1
3403,San Juan Biwall,Mancos Corrugated,3,920,1180,260,0,0,0
3403,San Juan Biwall,Mancos Gray,2,880,1060,180,0,1,0
3403,San Juan Biwall,McElmo Black-on-white,13,1060,1260,200,1,1,1
3403,San Juan Biwall,Mesa Verde Black-on-white,12,1180,1280,100,1,1,1
3403,San Juan Biwall,Mesa Verde Corrugated,7,1100,1280,180,0,1,0
3403,San Juan Biwall,"Mesa Verde Gray ware, Undifferentiated",5,575,1280,705,0,0,0
3403,San Juan Biwall,"Mesa Verde White Ware, Undifferentiated",8,575,1280,705,0,1,1
3403,San Juan Biwall,Piedra Black-on-white,3,800,920,120,1,1,1
3403,San Juan Biwall,"San Juan Red ware, Undifferentiated",2,700,1050,350,0,0,1
3404,Canal Creek Great Kiva,McElmo Black-on-white,2,1060,1260,200,1,1,1
3404,Canal Creek Great Kiva,Mesa Verde Black-on-white,4,1180,1280,100,1,1,1
3404,Canal Creek Great Kiva,Mesa Verde Corrugated,1,1100,1280,180,0,1,0
3404,Canal Creek Great Kiva,"Mesa Verde Gray ware, Undifferentiated",3,575,1280,705,0,0,0
3404,Canal Creek Great Kiva,"Mesa Verde White Ware, Undifferentiated",3,575,1280,705,0,1,1
3419,Battleship Rock Pueblo,Cortez Black-on-white,11,880,1060,180,1,1,1
3419,Battleship Rock Pueblo,Dolores Corrugated,1,1100,1200,100,0,1,0
3419,Battleship Rock Pueblo,Mancos Black-on-white,34,980,1180,200,1,1,1
3419,Battleship Rock Pueblo,Mancos Corrugated,11,920,1180,260,0,0,0
3419,Battleship Rock Pueblo,Mancos Gray,82,880,1060,180,0,1,0
3419,Battleship Rock Pueblo,"Mesa Verde Corrugated Gray Ware, Undifferentiated",91,920,1280,360,0,0,0
3419,Battleship Rock Pueblo,Mesa Verde Neckbanded Gray,10,800,1060,260,0,0,0
3419,Battleship Rock Pueblo,"Mesa Verde PI/PII White Ware, Type Undifferentiated",226,750,1180,430,0,1,1
3419,Battleship Rock Pueblo,"Mesa Verde PII White Ware, Type Undifferentiated",37,920,1100,180,1,1,1
3419,Battleship Rock Pueblo,"Mesa Verde PII/PIII White Ware, Type Undifferentiated",387,920,1280,360,0,1,1
3419,Battleship Rock Pueblo,"Mesa Verde PIII White Ware, Type Undifferentiated",1,1100,1280,180,1,1,1
3419,Battleship Rock Pueblo,Mesa Verde Plain Gray,84,575,1020,445,0,0,0
3419,Battleship Rock Pueblo,Moccasin Gray,43,800,980,180,0,1,0
3419,Battleship Rock Pueblo,Piedra Black-on-white,4,800,920,120,1,1,1
3419,Battleship Rock Pueblo,"San Juan Red ware, Undifferentiated",2,700,1050,350,0,0,1
3420,Shields Pueblo,Abajo Red-on-orange,20,760,880,120,1,1,1
3420,Shields Pueblo,Bluff Black-on-red,12,800,925,125,1,1,1
3420,Shields Pueblo,Chapin Black-on-white,159,575,880,305,0,1,1
3420,Shields Pueblo,Chapin Gray,344,575,980,405,0,0,0
3420,Shields Pueblo,Cortez Black-on-white,112,880,1060,180,1,1,1
3420,Shields Pueblo,Deadmans (La Plata) Black-on-red,64,880,1050,170,1,1,1
3420,Shields Pueblo,"Gray Ware, Undifferentiated",112,400,1400,1000,0,0,0
3420,Shields Pueblo,Mancos Black-on-white,7864,980,1180,200,1,1,1
3420,Shields Pueblo,Mancos Corrugated,1060,920,1180,260,0,0,0
3420,Shields Pueblo,Mancos Gray,22,880,1060,180,0,1,0
3420,Shields Pueblo,McElmo Black-on-white,4709,1060,1260,200,1,1,1
3420,Shields Pueblo,Mesa Verde Black-on-white,1965,1180,1280,100,1,1,1
3420,Shields Pueblo,Mesa Verde Corrugated,1812,1100,1280,180,0,1,0
3420,Shields Pueblo,"Mesa Verde Corrugated Gray Ware, Undifferentiated",105556,920,1280,360,0,0,0
3420,Shields Pueblo,"Mesa Verde Gray ware, Undifferentiated",14600,575,1280,705,0,0,0
3420,Shields Pueblo,Mesa Verde Neckbanded Gray,3,800,1060,260,0,0,0
3420,Shields Pueblo,"Mesa Verde PI/PII White Ware, Type Undifferentiated",1585,750,1180,430,0,1,1
3420,Shields Pueblo,"Mesa Verde PII White Ware, Type Undifferentiated",462,920,1100,180,1,1,1
3420,Shields Pueblo,"Mesa Verde PII/PIII White Ware, Type Undifferentiated",72787,920,1280,360,0,1,1
3420,Shields Pueblo,"Mesa Verde PIII White Ware, Type Undifferentiated",9238,1100,1280,180,1,1,1
3420,Shields Pueblo,"Mesa Verde White Ware, Undifferentiated",912,575,1280,705,0,1,1
3420,Shields Pueblo,Moccasin Gray,9,800,980,180,0,1,0
3420,Shields Pueblo,"Mudware, Undifferentiated",9,400,1400,1000,0,0,0
3420,Shields Pueblo,Mummy Lake Gray,9,1150,1280,130,0,1,0
3420,Shields Pueblo,Piedra Black-on-white,86,800,920,120,1,1,1
3420,Shields Pueblo,"Polychrome, Undifferentiated",36,700,1900,1200,0,1,1
3420,Shields Pueblo,"Red Ware type, Undifferentiated",475,700,1700,1000,0,0,0
3420,Shields Pueblo,"San Juan Red ware, Undifferentiated",173,700,1050,350,0,0,1
3420,Shields Pueblo,"Type, Undifferentiated",1564,200,1900,1700,0,0,0
3420,Shields Pueblo,"White ware, Undifferentiated",67,550,1900,1350,0,0,1
3428,Bowman Site East,Chaco Black-on-white,1,1075,1150,75,1,1,1
3428,Bowman Site East,Chaco-McElmo Black-on-white (carbon paint),1,1090,1175,85,1,1,1
3428,Bowman Site East,Cibola Clapboard Corrugated Gray,8,900,1100,200,0,1,0
3428,Bowman Site East,Cibola Indented Corrugated Gray,15,1040,1400,360,0,0,0
3428,Bowman Site East,Cibola Narrow Neckbanded,2,900,1025,125,0,1,0
3428,Bowman Site East,"Cibola PII Gray Ware, Type Undifferentiated",1,950,1100,150,0,1,0
3428,Bowman Site East,"Cibola PII/PIII White Ware, Type Undifferentiated",18,1000,1300,300,1,1,1
3428,Bowman Site East,"Cibola White Ware, Undifferentiated",2,550,1325,775,0,1,1
3428,Bowman Site East,Cibola Wide Neckbanded,4,850,925,75,0,1,0
3428,Bowman Site East,Dogoszhi Black-on-white,1,1040,1210,170,1,1,1
3428,Bowman Site East,Escavada Black-on-white,10,1000,1100,100,1,1,1
3428,Bowman Site East,Gallup Black-on-white,14,1040,1150,110,1,1,1
3428,Bowman Site East,La Plata-White Mound Black-on-white,1,550,850,300,1,1,1
3428,Bowman Site East,Lino Black-on-gray (Cibola),1,600,850,250,1,1,1
3428,Bowman Site East,"Mesa Verde White Ware, Undifferentiated",1,575,1280,705,0,1,1
3428,Bowman Site East,Newcomb Black-on-white,1,875,1000,125,1,1,1
3428,Bowman Site East,Puerco Black-on-white,2,1030,1200,170,1,1,1
3428,Bowman Site East,Red Mesa Black-on-white,27,880,1040,160,1,1,1
3428,Bowman Site East,Reserve Black-on-white,5,1050,1200,150,1,1,1
3428,Bowman Site East,"White Mountain type, Type Undifferentiated; Early",1,1000,1300,300,0,0,1
3428,Bowman Site East,Wingate Black-on-red,1,1050,1225,175,1,1,1
3428,Bowman Site East,Woodruff Smudged,1,500,1100,600,0,0,0
3429,Dye Wash,Chaco Black-on-white,2,1075,1150,75,1,1,1
3429,Dye Wash,Chaco-McElmo Black-on-white (carbon paint),2,1090,1175,85,1,1,1
3429,Dye Wash,Chuska Indented Corrugated Gray,3,1040,1300,260,0,0,0
3429,Dye Wash,Cibola Clapboard Corrugated Gray,4,900,1100,200,0,1,0
3429,Dye Wash,Cibola Indented Corrugated Gray,15,1040,1400,360,0,0,0
3429,Dye Wash,Cibola Narrow Neckbanded,2,900,1025,125,0,1,0
3429,Dye Wash,"Cibola PII/PIII White Ware, Type Undifferentiated",12,1000,1300,300,1,1,1
3429,Dye Wash,"Cibola White Ware, Undifferentiated",1,550,1325,775,0,1,1
3429,Dye Wash,Dogoszhi Black-on-white,1,1040,1210,170,1,1,1
3429,Dye Wash,Escavada Black-on-white,7,1000,1100,100,1,1,1
3429,Dye Wash,Flagstaff Black-on-white,1,1150,1220,70,1,1,1
3429,Dye Wash,Gallup Black-on-white,9,1040,1150,110,1,1,1
3429,Dye Wash,Kiatuthlanna Black-on-white,2,850,925,75,1,1,1
3429,Dye Wash,Kiatuthlanna-Red Mesa Black-on-white,1,850,1040,190,1,1,1
3429,Dye Wash,Puerco Black-on-white,2,1030,1200,170,1,1,1
3429,Dye Wash,Red Mesa Black-on-white,12,880,1040,160,1,1,1
3429,Dye Wash,Reserve Black-on-white,3,1050,1200,150,1,1,1
3429,Dye Wash,"San Juan Red ware, Undifferentiated",1,700,1050,350,0,0,1
3429,Dye Wash,Snowflake Black-on-white,2,1100,1275,175,1,1,1
3429,Dye Wash,Sosi Black-on-white,2,1070,1180,110,1,1,1
3429,Dye Wash,Springerville Polychrome,3,1250,1300,50,1,1,1
3429,Dye Wash,St. Johns Polychrome,6,1200,1300,100,1,1,1
3429,Dye Wash,Tularosa Black-on-white,2,1180,1300,120,1,1,1
3429,Dye Wash,White Mound Black-on-white,1,700,850,150,1,1,1
3429,Dye Wash,"White Mountain type, Type Undifferentiated; Early",2,1000,1300,300,0,0,1
3429,Dye Wash,Wingate Black-on-red,1,1050,1225,175,1,1,1
3429,Dye Wash,Wingate Polychrome,2,1100,1225,125,1,1,1
3429,Dye Wash,Wingate/St. Johns Black-on-red or polychrome,1,1050,1300,250,1,1,1
3457,Cottonwood Seep,"Brown Ware, Undifferentiated",2,500,1450,950,0,0,0
3457,Cottonwood Seep,"Cibola BMIII/PI White Ware, Type Undifferentiated",10,550,900,350,0,1,1
3457,Cottonwood Seep,"Cibola White Ware, Undifferentiated",6,550,1325,775,0,1,1
3457,Cottonwood Seep,"Gray Ware, Undifferentiated",6,400,1400,1000,0,0,0
3457,Cottonwood Seep,Kana-a Black-on-white,8,825,1000,175,1,1,1
3457,Cottonwood Seep,Kana'a Gray Ware,6,865,1060,195,0,1,0
3457,Cottonwood Seep,Kiatuthlanna Black-on-white,2,850,925,75,1,1,1
3457,Cottonwood Seep,La Plata Black-on-white,26,550,750,200,1,1,1
3457,Cottonwood Seep,Lino Black-on-gray (Tusayan),6,600,850,250,1,1,1
3457,Cottonwood Seep,Lino Gray (Tusayan),326,550,950,400,0,0,0
3457,Cottonwood Seep,Lino Gray Fugitive Red [Cibola Series],78,550,850,300,1,0,0
3457,Cottonwood Seep,"Little Colorado White Ware, Undifferentiated",2,825,1250,425,0,1,1
3457,Cottonwood Seep,"Mogollon Brown ware, Undifferentiated",4,900,1400,500,0,0,0
3457,Cottonwood Seep,Mogollon Plain Brown Ware,50,300,1400,1100,0,0,0
3457,Cottonwood Seep,Obelisk Gray,50,400,700,300,0,0,0
3457,Cottonwood Seep,"Orange Ware, Undifferentiated",22,1000,1350,350,0,0,0
3457,Cottonwood Seep,"Puerco Valley Corrugated Gray Ware, Undifferentiated",4,800,1300,500,0,0,0
3457,Cottonwood Seep,"Puerco Valley Gray Ware, Undifferentiated",1856,400,1300,900,0,0,0
3457,Cottonwood Seep,Red Mesa Black-on-white,2,880,1040,160,1,1,1
3457,Cottonwood Seep,"Red Ware type, Undifferentiated",60,700,1700,1000,0,0,0
3457,Cottonwood Seep,"Tusayan BMIII/PI White Ware, Type Undifferentiated",2,600,900,300,1,1,1
3457,Cottonwood Seep,Tusayan Clapboard Corrugated,4,1030,1100,70,0,1,0
3457,Cottonwood Seep,"Tusayan Gray Ware, Undifferentiated",824,550,1285,735,0,0,0
3457,Cottonwood Seep,Tusayan Plain Gray,170,600,1300,700,0,0,0
3457,Cottonwood Seep,"Tusayan White Ware, Undifferentiated",2,825,1300,475,0,1,1
3457,Cottonwood Seep,White Mound Black-on-white,90,700,850,150,1,1,1
3457,Cottonwood Seep,"White ware, Undifferentiated",24,550,1900,1350,0,0,1
3457,Cottonwood Seep,Woodruff Brown,98,500,1100,600,0,0,0
3457,Cottonwood Seep,Woodruff Red,24,400,1100,700,0,0,0
3457,Cottonwood Seep,Woodruff Smudged,194,500,1100,600,0,0,0
